LA code,LA name,Age,Inflow,Outflow,Net
E07000223,Adur,0-4,252,238,14
E07000223,Adur,44079,178,167,11
E07000223,Adur,41913,173,118,55
E07000223,Adur,15-19,158,325,-167
E07000223,Adur,20-24,455,428,27
E07000223,Adur,25-29,424,446,-22
E07000223,Adur,30-34,456,393,63
E07000223,Adur,35-39,321,295,26
E07000223,Adur,40-44,276,215,61
E07000223,Adur,45-49,254,208,46
E07000223,Adur,50-54,198,207,-9
E07000223,Adur,55-59,173,154,19
E07000223,Adur,60-64,146,111,35
E07000223,Adur,65-69,108,94,14
E07000223,Adur,70-74,86,78,8
E07000223,Adur,75-79,59,67,-8
E07000223,Adur,80-84,63,66,-3
E07000223,Adur,85-89,19,56,-37
E07000223,Adur,90+,29,48,-19
E07000026,Allerdale,0-4,182,113,69
E07000026,Allerdale,05-Sep,210,100,110
E07000026,Allerdale,41913,158,96,62
E07000026,Allerdale,15-19,137,350,-213
E07000026,Allerdale,20-24,506,468,38
E07000026,Allerdale,25-29,402,364,38
E07000026,Allerdale,30-34,272,241,31
E07000026,Allerdale,35-39,222,160,62
E07000026,Allerdale,40-44,208,155,53
E07000026,Allerdale,45-49,215,165,50
E07000026,Allerdale,50-54,221,153,68
E07000026,Allerdale,55-59,200,132,68
E07000026,Allerdale,60-64,185,128,57
E07000026,Allerdale,65-69,130,126,4
E07000026,Allerdale,70-74,81,88,-7
E07000026,Allerdale,75-79,53,64,-11
E07000026,Allerdale,80-84,47,24,23
E07000026,Allerdale,85-89,43,25,18
E07000026,Allerdale,90+,38,24,14
E07000032,Amber Valley,0-4,432,333,99
E07000032,Amber Valley,05-Sep,312,213,99
E07000032,Amber Valley,41913,193,211,-18
E07000032,Amber Valley,15-19,259,540,-281
E07000032,Amber Valley,20-24,897,785,112
E07000032,Amber Valley,25-29,870,734,136
E07000032,Amber Valley,30-34,672,485,187
E07000032,Amber Valley,35-39,463,374,89
E07000032,Amber Valley,40-44,369,310,59
E07000032,Amber Valley,45-49,383,285,98
E07000032,Amber Valley,50-54,346,267,79
E07000032,Amber Valley,55-59,305,242,63
E07000032,Amber Valley,60-64,236,177,59
E07000032,Amber Valley,65-69,165,148,17
E07000032,Amber Valley,70-74,132,102,30
E07000032,Amber Valley,75-79,85,79,6
E07000032,Amber Valley,80-84,57,57,0
E07000032,Amber Valley,85-89,65,38,27
E07000032,Amber Valley,90+,60,33,27
E07000224,Arun,0-4,418,323,95
E07000224,Arun,05-Sep,363,200,163
E07000224,Arun,41913,245,199,46
E07000224,Arun,15-19,370,590,-220
E07000224,Arun,20-24,1059,1235,-176
E07000224,Arun,25-29,852,726,126
E07000224,Arun,30-34,707,578,129
E07000224,Arun,35-39,534,400,134
E07000224,Arun,40-44,418,302,116
E07000224,Arun,45-49,471,311,160
E07000224,Arun,50-54,513,338,175
E07000224,Arun,55-59,535,324,211
E07000224,Arun,60-64,524,261,263
E07000224,Arun,65-69,518,223,295
E07000224,Arun,70-74,392,231,161
E07000224,Arun,75-79,229,160,69
E07000224,Arun,80-84,156,160,-4
E07000224,Arun,85-89,140,145,-5
E07000224,Arun,90+,149,147,2
E07000170,Ashfield,0-4,522,457,65
E07000170,Ashfield,05-Sep,398,315,83
E07000170,Ashfield,41913,279,217,62
E07000170,Ashfield,15-19,277,502,-225
E07000170,Ashfield,20-24,920,733,187
E07000170,Ashfield,25-29,1018,787,231
E07000170,Ashfield,30-34,706,576,130
E07000170,Ashfield,35-39,555,439,116
E07000170,Ashfield,40-44,379,321,58
E07000170,Ashfield,45-49,361,334,27
E07000170,Ashfield,50-54,338,285,53
E07000170,Ashfield,55-59,294,261,33
E07000170,Ashfield,60-64,191,201,-10
E07000170,Ashfield,65-69,161,128,33
E07000170,Ashfield,70-74,105,99,6
E07000170,Ashfield,75-79,70,61,9
E07000170,Ashfield,80-84,64,57,7
E07000170,Ashfield,85-89,54,39,15
E07000170,Ashfield,90+,42,23,19
E07000105,Ashford,0-4,466,312,154
E07000105,Ashford,05-Sep,371,237,134
E07000105,Ashford,41913,285,193,92
E07000105,Ashford,15-19,263,668,-405
E07000105,Ashford,20-24,993,782,211
E07000105,Ashford,25-29,780,629,151
E07000105,Ashford,30-34,714,495,219
E07000105,Ashford,35-39,517,340,177
E07000105,Ashford,40-44,409,269,140
E07000105,Ashford,45-49,378,293,85
E07000105,Ashford,50-54,321,303,18
E07000105,Ashford,55-59,292,282,10
E07000105,Ashford,60-64,217,202,15
E07000105,Ashford,65-69,182,146,36
E07000105,Ashford,70-74,164,170,-6
E07000105,Ashford,75-79,103,81,22
E07000105,Ashford,80-84,64,68,-4
E07000105,Ashford,85-89,65,50,15
E07000105,Ashford,90+,54,36,18
E07000004,Aylesbury Vale,0-4,860,538,322
E07000004,Aylesbury Vale,05-Sep,595,367,228
E07000004,Aylesbury Vale,41913,538,398,140
E07000004,Aylesbury Vale,15-19,549,1316,-767
E07000004,Aylesbury Vale,20-24,1811,1392,419
E07000004,Aylesbury Vale,25-29,1553,1257,296
E07000004,Aylesbury Vale,30-34,1381,981,400
E07000004,Aylesbury Vale,35-39,1055,681,374
E07000004,Aylesbury Vale,40-44,726,564,162
E07000004,Aylesbury Vale,45-49,637,528,109
E07000004,Aylesbury Vale,50-54,512,617,-105
E07000004,Aylesbury Vale,55-59,402,448,-46
E07000004,Aylesbury Vale,60-64,279,417,-138
E07000004,Aylesbury Vale,65-69,221,275,-54
E07000004,Aylesbury Vale,70-74,213,208,5
E07000004,Aylesbury Vale,75-79,115,110,5
E07000004,Aylesbury Vale,80-84,100,73,27
E07000004,Aylesbury Vale,85-89,113,72,41
E07000004,Aylesbury Vale,90+,90,48,42
E07000200,Babergh,0-4,387,250,137
E07000200,Babergh,05-Sep,298,222,76
E07000200,Babergh,41913,249,208,41
E07000200,Babergh,15-19,238,492,-254
E07000200,Babergh,20-24,709,622,87
E07000200,Babergh,25-29,632,586,46
E07000200,Babergh,30-34,468,391,77
E07000200,Babergh,35-39,417,269,148
E07000200,Babergh,40-44,305,260,45
E07000200,Babergh,45-49,283,258,25
E07000200,Babergh,50-54,308,218,90
E07000200,Babergh,55-59,288,216,72
E07000200,Babergh,60-64,215,183,32
E07000200,Babergh,65-69,208,162,46
E07000200,Babergh,70-74,146,155,-9
E07000200,Babergh,75-79,110,77,33
E07000200,Babergh,80-84,88,67,21
E07000200,Babergh,85-89,75,60,15
E07000200,Babergh,90+,75,36,39
E09000002,Barking and Dagenham,0-4,1647,2005,-358
E09000002,Barking and Dagenham,05-Sep,1017,1579,-562
E09000002,Barking and Dagenham,41913,724,1081,-357
E09000002,Barking and Dagenham,15-19,668,1280,-612
E09000002,Barking and Dagenham,20-24,1700,1712,-12
E09000002,Barking and Dagenham,25-29,1919,2125,-206
E09000002,Barking and Dagenham,30-34,2030,2182,-152
E09000002,Barking and Dagenham,35-39,1550,1864,-314
E09000002,Barking and Dagenham,40-44,979,1216,-237
E09000002,Barking and Dagenham,45-49,701,858,-157
E09000002,Barking and Dagenham,50-54,496,705,-209
E09000002,Barking and Dagenham,55-59,339,590,-251
E09000002,Barking and Dagenham,60-64,175,397,-222
E09000002,Barking and Dagenham,65-69,101,280,-179
E09000002,Barking and Dagenham,70-74,71,185,-114
E09000002,Barking and Dagenham,75-79,60,104,-44
E09000002,Barking and Dagenham,80-84,34,89,-55
E09000002,Barking and Dagenham,85-89,25,85,-60
E09000002,Barking and Dagenham,90+,22,64,-42
E09000003,Barnet,0-4,1666,2016,-350
E09000003,Barnet,05-Sep,948,1099,-151
E09000003,Barnet,41913,784,883,-99
E09000003,Barnet,15-19,1057,2296,-1239
E09000003,Barnet,20-24,4974,3984,990
E09000003,Barnet,25-29,4096,4363,-267
E09000003,Barnet,30-34,3628,4058,-430
E09000003,Barnet,35-39,2548,2854,-306
E09000003,Barnet,40-44,1594,1767,-173
E09000003,Barnet,45-49,1190,1264,-74
E09000003,Barnet,50-54,866,980,-114
E09000003,Barnet,55-59,554,758,-204
E09000003,Barnet,60-64,421,488,-67
E09000003,Barnet,65-69,299,415,-116
E09000003,Barnet,70-74,213,269,-56
E09000003,Barnet,75-79,151,187,-36
E09000003,Barnet,80-84,127,150,-23
E09000003,Barnet,85-89,127,134,-7
E09000003,Barnet,90+,121,119,2
E08000016,Barnsley,0-4,601,461,140
E08000016,Barnsley,05-Sep,351,355,-4
E08000016,Barnsley,41913,370,260,110
E08000016,Barnsley,15-19,303,790,-487
E08000016,Barnsley,20-24,1431,1048,383
E08000016,Barnsley,25-29,1127,913,214
E08000016,Barnsley,30-34,865,775,90
E08000016,Barnsley,35-39,634,586,48
E08000016,Barnsley,40-44,438,369,69
E08000016,Barnsley,45-49,493,388,105
E08000016,Barnsley,50-54,458,356,102
E08000016,Barnsley,55-59,347,235,112
E08000016,Barnsley,60-64,253,164,89
E08000016,Barnsley,65-69,186,139,47
E08000016,Barnsley,70-74,149,103,46
E08000016,Barnsley,75-79,62,76,-14
E08000016,Barnsley,80-84,53,33,20
E08000016,Barnsley,85-89,48,48,0
E08000016,Barnsley,90+,24,22,2
E07000027,Barrow-in-Furness,0-4,100,91,9
E07000027,Barrow-in-Furness,05-Sep,71,81,-10
E07000027,Barrow-in-Furness,41913,79,72,7
E07000027,Barrow-in-Furness,15-19,87,191,-104
E07000027,Barrow-in-Furness,20-24,368,252,116
E07000027,Barrow-in-Furness,25-29,233,216,17
E07000027,Barrow-in-Furness,30-34,182,152,30
E07000027,Barrow-in-Furness,35-39,102,103,-1
E07000027,Barrow-in-Furness,40-44,106,97,9
E07000027,Barrow-in-Furness,45-49,85,82,3
E07000027,Barrow-in-Furness,50-54,82,81,1
E07000027,Barrow-in-Furness,55-59,62,71,-9
E07000027,Barrow-in-Furness,60-64,52,48,4
E07000027,Barrow-in-Furness,65-69,34,50,-16
E07000027,Barrow-in-Furness,70-74,31,48,-17
E07000027,Barrow-in-Furness,75-79,32,38,-6
E07000027,Barrow-in-Furness,80-84,20,36,-16
E07000027,Barrow-in-Furness,85-89,17,19,-2
E07000027,Barrow-in-Furness,90+,10,23,-13
E07000066,Basildon,0-4,784,623,161
E07000066,Basildon,05-Sep,482,476,6
E07000066,Basildon,41913,370,363,7
E07000066,Basildon,15-19,384,832,-448
E07000066,Basildon,20-24,1354,945,409
E07000066,Basildon,25-29,1456,1126,330
E07000066,Basildon,30-34,1248,1023,225
E07000066,Basildon,35-39,828,743,85
E07000066,Basildon,40-44,545,514,31
E07000066,Basildon,45-49,448,455,-7
E07000066,Basildon,50-54,409,451,-42
E07000066,Basildon,55-59,285,442,-157
E07000066,Basildon,60-64,193,300,-107
E07000066,Basildon,65-69,117,250,-133
E07000066,Basildon,70-74,125,167,-42
E07000066,Basildon,75-79,71,85,-14
E07000066,Basildon,80-84,78,85,-7
E07000066,Basildon,85-89,65,79,-14
E07000066,Basildon,90+,62,82,-20
E07000084,Basingstoke and Deane,0-4,549,483,66
E07000084,Basingstoke and Deane,05-Sep,316,372,-56
E07000084,Basingstoke and Deane,41913,280,409,-129
E07000084,Basingstoke and Deane,15-19,287,815,-528
E07000084,Basingstoke and Deane,20-24,1598,1085,513
E07000084,Basingstoke and Deane,25-29,1345,1155,190
E07000084,Basingstoke and Deane,30-34,1076,952,124
E07000084,Basingstoke and Deane,35-39,727,741,-14
E07000084,Basingstoke and Deane,40-44,493,464,29
E07000084,Basingstoke and Deane,45-49,397,439,-42
E07000084,Basingstoke and Deane,50-54,364,478,-114
E07000084,Basingstoke and Deane,55-59,277,385,-108
E07000084,Basingstoke and Deane,60-64,183,267,-84
E07000084,Basingstoke and Deane,65-69,137,239,-102
E07000084,Basingstoke and Deane,70-74,104,140,-36
E07000084,Basingstoke and Deane,75-79,71,62,9
E07000084,Basingstoke and Deane,80-84,73,49,24
E07000084,Basingstoke and Deane,85-89,69,41,28
E07000084,Basingstoke and Deane,90+,68,26,42
E07000171,Bassetlaw,0-4,317,253,64
E07000171,Bassetlaw,05-Sep,285,219,66
E07000171,Bassetlaw,41913,224,154,70
E07000171,Bassetlaw,15-19,203,571,-368
E07000171,Bassetlaw,20-24,816,668,148
E07000171,Bassetlaw,25-29,589,527,62
E07000171,Bassetlaw,30-34,459,419,40
E07000171,Bassetlaw,35-39,407,312,95
E07000171,Bassetlaw,40-44,287,207,80
E07000171,Bassetlaw,45-49,283,216,67
E07000171,Bassetlaw,50-54,296,260,36
E07000171,Bassetlaw,55-59,259,175,84
E07000171,Bassetlaw,60-64,210,170,40
E07000171,Bassetlaw,65-69,171,145,26
E07000171,Bassetlaw,70-74,137,94,43
E07000171,Bassetlaw,75-79,82,51,31
E07000171,Bassetlaw,80-84,63,43,20
E07000171,Bassetlaw,85-89,61,29,32
E07000171,Bassetlaw,90+,38,27,11
E06000022,Bath and North East Somerset,0-4,529,404,125
E06000022,Bath and North East Somerset,05-Sep,413,269,144
E06000022,Bath and North East Somerset,41913,368,241,127
E06000022,Bath and North East Somerset,15-19,3885,948,2937
E06000022,Bath and North East Somerset,20-24,5063,6999,-1936
E06000022,Bath and North East Somerset,25-29,1701,1948,-247
E06000022,Bath and North East Somerset,30-34,1157,1078,79
E06000022,Bath and North East Somerset,35-39,841,677,164
E06000022,Bath and North East Somerset,40-44,561,465,96
E06000022,Bath and North East Somerset,45-49,517,457,60
E06000022,Bath and North East Somerset,50-54,404,375,29
E06000022,Bath and North East Somerset,55-59,316,328,-12
E06000022,Bath and North East Somerset,60-64,241,289,-48
E06000022,Bath and North East Somerset,65-69,182,231,-49
E06000022,Bath and North East Somerset,70-74,158,164,-6
E06000022,Bath and North East Somerset,75-79,111,98,13
E06000022,Bath and North East Somerset,80-84,113,65,48
E06000022,Bath and North East Somerset,85-89,101,77,24
E06000022,Bath and North East Somerset,90+,85,79,6
E06000055,Bedford,0-4,692,449,243
E06000055,Bedford,05-Sep,426,301,125
E06000055,Bedford,41913,344,269,75
E06000055,Bedford,15-19,458,994,-536
E06000055,Bedford,20-24,1766,1527,239
E06000055,Bedford,25-29,1359,1181,178
E06000055,Bedford,30-34,1111,833,278
E06000055,Bedford,35-39,764,614,150
E06000055,Bedford,40-44,533,450,83
E06000055,Bedford,45-49,441,406,35
E06000055,Bedford,50-54,389,418,-29
E06000055,Bedford,55-59,244,337,-93
E06000055,Bedford,60-64,219,217,2
E06000055,Bedford,65-69,159,167,-8
E06000055,Bedford,70-74,129,132,-3
E06000055,Bedford,75-79,59,64,-5
E06000055,Bedford,80-84,51,41,10
E06000055,Bedford,85-89,51,48,3
E06000055,Bedford,90+,44,26,18
E09000004,Bexley,0-4,1223,1141,82
E09000004,Bexley,05-Sep,860,892,-32
E09000004,Bexley,41913,615,649,-34
E09000004,Bexley,15-19,613,1395,-782
E09000004,Bexley,20-24,2039,1697,342
E09000004,Bexley,25-29,1683,1784,-101
E09000004,Bexley,30-34,1784,1515,269
E09000004,Bexley,35-39,1529,1207,322
E09000004,Bexley,40-44,892,876,16
E09000004,Bexley,45-49,666,741,-75
E09000004,Bexley,50-54,556,671,-115
E09000004,Bexley,55-59,350,548,-198
E09000004,Bexley,60-64,230,384,-154
E09000004,Bexley,65-69,132,294,-162
E09000004,Bexley,70-74,118,201,-83
E09000004,Bexley,75-79,101,126,-25
E09000004,Bexley,80-84,84,104,-20
E09000004,Bexley,85-89,105,84,21
E09000004,Bexley,90+,108,78,30
E08000025,Birmingham,0-4,2737,3811,-1074
E08000025,Birmingham,05-Sep,1849,2612,-763
E08000025,Birmingham,41913,1415,2011,-596
E08000025,Birmingham,15-19,8335,3907,4428
E08000025,Birmingham,20-24,12310,16304,-3994
E08000025,Birmingham,25-29,7093,8770,-1677
E08000025,Birmingham,30-34,4899,6300,-1401
E08000025,Birmingham,35-39,3374,4572,-1198
E08000025,Birmingham,40-44,2105,2921,-816
E08000025,Birmingham,45-49,1788,2362,-574
E08000025,Birmingham,50-54,1287,1892,-605
E08000025,Birmingham,55-59,888,1496,-608
E08000025,Birmingham,60-64,583,1077,-494
E08000025,Birmingham,65-69,395,839,-444
E08000025,Birmingham,70-74,320,563,-243
E08000025,Birmingham,75-79,271,379,-108
E08000025,Birmingham,80-84,245,337,-92
E08000025,Birmingham,85-89,216,275,-59
E08000025,Birmingham,90+,163,262,-99
E07000129,Blaby,0-4,472,395,77
E07000129,Blaby,05-Sep,385,231,154
E07000129,Blaby,41913,301,204,97
E07000129,Blaby,15-19,251,514,-263
E07000129,Blaby,20-24,1007,694,313
E07000129,Blaby,25-29,920,708,212
E07000129,Blaby,30-34,898,568,330
E07000129,Blaby,35-39,580,415,165
E07000129,Blaby,40-44,385,278,107
E07000129,Blaby,45-49,296,296,0
E07000129,Blaby,50-54,306,259,47
E07000129,Blaby,55-59,207,244,-37
E07000129,Blaby,60-64,178,175,3
E07000129,Blaby,65-69,144,123,21
E07000129,Blaby,70-74,94,95,-1
E07000129,Blaby,75-79,90,62,28
E07000129,Blaby,80-84,74,74,0
E07000129,Blaby,85-89,80,57,23
E07000129,Blaby,90+,57,66,-9
E06000008,Blackburn with Darwen,0-4,351,434,-83
E06000008,Blackburn with Darwen,05-Sep,287,377,-90
E06000008,Blackburn with Darwen,41913,229,290,-61
E06000008,Blackburn with Darwen,15-19,224,595,-371
E06000008,Blackburn with Darwen,20-24,1044,900,144
E06000008,Blackburn with Darwen,25-29,709,799,-90
E06000008,Blackburn with Darwen,30-34,523,620,-97
E06000008,Blackburn with Darwen,35-39,408,429,-21
E06000008,Blackburn with Darwen,40-44,278,330,-52
E06000008,Blackburn with Darwen,45-49,247,321,-74
E06000008,Blackburn with Darwen,50-54,237,272,-35
E06000008,Blackburn with Darwen,55-59,160,231,-71
E06000008,Blackburn with Darwen,60-64,102,185,-83
E06000008,Blackburn with Darwen,65-69,81,159,-78
E06000008,Blackburn with Darwen,70-74,58,96,-38
E06000008,Blackburn with Darwen,75-79,40,77,-37
E06000008,Blackburn with Darwen,80-84,42,43,-1
E06000008,Blackburn with Darwen,85-89,30,57,-27
E06000008,Blackburn with Darwen,90+,29,26,3
E06000009,Blackpool,0-4,480,510,-30
E06000009,Blackpool,05-Sep,436,387,49
E06000009,Blackpool,41913,390,374,16
E06000009,Blackpool,15-19,459,673,-214
E06000009,Blackpool,20-24,1125,879,246
E06000009,Blackpool,25-29,827,939,-112
E06000009,Blackpool,30-34,682,730,-48
E06000009,Blackpool,35-39,477,557,-80
E06000009,Blackpool,40-44,463,418,45
E06000009,Blackpool,45-49,443,466,-23
E06000009,Blackpool,50-54,425,455,-30
E06000009,Blackpool,55-59,365,412,-47
E06000009,Blackpool,60-64,313,299,14
E06000009,Blackpool,65-69,240,222,18
E06000009,Blackpool,70-74,174,209,-35
E06000009,Blackpool,75-79,131,136,-5
E06000009,Blackpool,80-84,81,100,-19
E06000009,Blackpool,85-89,53,76,-23
E06000009,Blackpool,90+,44,58,-14
E07000033,Bolsover,0-4,326,306,20
E07000033,Bolsover,05-Sep,240,241,-1
E07000033,Bolsover,41913,193,190,3
E07000033,Bolsover,15-19,191,361,-170
E07000033,Bolsover,20-24,658,534,124
E07000033,Bolsover,25-29,688,585,103
E07000033,Bolsover,30-34,449,421,28
E07000033,Bolsover,35-39,359,333,26
E07000033,Bolsover,40-44,251,206,45
E07000033,Bolsover,45-49,282,245,37
E07000033,Bolsover,50-54,261,181,80
E07000033,Bolsover,55-59,259,198,61
E07000033,Bolsover,60-64,169,135,34
E07000033,Bolsover,65-69,117,97,20
E07000033,Bolsover,70-74,84,91,-7
E07000033,Bolsover,75-79,61,58,3
E07000033,Bolsover,80-84,46,45,1
E07000033,Bolsover,85-89,38,25,13
E07000033,Bolsover,90+,27,23,4
E08000001,Bolton,0-4,792,736,56
E08000001,Bolton,05-Sep,531,590,-59
E08000001,Bolton,41913,400,474,-74
E08000001,Bolton,15-19,548,1121,-573
E08000001,Bolton,20-24,1888,1869,19
E08000001,Bolton,25-29,1408,1474,-66
E08000001,Bolton,30-34,1153,1100,53
E08000001,Bolton,35-39,783,843,-60
E08000001,Bolton,40-44,531,647,-116
E08000001,Bolton,45-49,448,556,-108
E08000001,Bolton,50-54,390,455,-65
E08000001,Bolton,55-59,297,413,-116
E08000001,Bolton,60-64,196,310,-114
E08000001,Bolton,65-69,159,231,-72
E08000001,Bolton,70-74,134,168,-34
E08000001,Bolton,75-79,89,96,-7
E08000001,Bolton,80-84,68,78,-10
E08000001,Bolton,85-89,51,53,-2
E08000001,Bolton,90+,27,58,-31
E07000136,Boston,0-4,208,201,7
E07000136,Boston,05-Sep,173,148,25
E07000136,Boston,41913,124,119,5
E07000136,Boston,15-19,135,310,-175
E07000136,Boston,20-24,437,460,-23
E07000136,Boston,25-29,357,426,-69
E07000136,Boston,30-34,248,279,-31
E07000136,Boston,35-39,176,190,-14
E07000136,Boston,40-44,167,146,21
E07000136,Boston,45-49,149,144,5
E07000136,Boston,50-54,174,145,29
E07000136,Boston,55-59,177,105,72
E07000136,Boston,60-64,137,100,37
E07000136,Boston,65-69,119,89,30
E07000136,Boston,70-74,65,66,-1
E07000136,Boston,75-79,48,55,-7
E07000136,Boston,80-84,35,42,-7
E07000136,Boston,85-89,36,44,-8
E07000136,Boston,90+,19,13,6
E06000028,Bournemouth,0-4,516,773,-257
E06000028,Bournemouth,05-Sep,366,491,-125
E06000028,Bournemouth,41913,310,364,-54
E06000028,Bournemouth,15-19,2809,827,1982
E06000028,Bournemouth,20-24,4786,6407,-1621
E06000028,Bournemouth,25-29,1830,2536,-706
E06000028,Bournemouth,30-34,1396,1835,-439
E06000028,Bournemouth,35-39,1070,1282,-212
E06000028,Bournemouth,40-44,744,781,-37
E06000028,Bournemouth,45-49,681,742,-61
E06000028,Bournemouth,50-54,598,608,-10
E06000028,Bournemouth,55-59,473,497,-24
E06000028,Bournemouth,60-64,381,372,9
E06000028,Bournemouth,65-69,270,313,-43
E06000028,Bournemouth,70-74,209,248,-39
E06000028,Bournemouth,75-79,125,150,-25
E06000028,Bournemouth,80-84,111,146,-35
E06000028,Bournemouth,85-89,108,117,-9
E06000028,Bournemouth,90+,138,117,21
E06000036,Bracknell Forest,0-4,471,411,60
E06000036,Bracknell Forest,05-Sep,304,293,11
E06000036,Bracknell Forest,41913,421,272,149
E06000036,Bracknell Forest,15-19,279,690,-411
E06000036,Bracknell Forest,20-24,1103,815,288
E06000036,Bracknell Forest,25-29,1097,824,273
E06000036,Bracknell Forest,30-34,942,794,148
E06000036,Bracknell Forest,35-39,707,590,117
E06000036,Bracknell Forest,40-44,399,459,-60
E06000036,Bracknell Forest,45-49,355,350,5
E06000036,Bracknell Forest,50-54,267,337,-70
E06000036,Bracknell Forest,55-59,203,331,-128
E06000036,Bracknell Forest,60-64,155,235,-80
E06000036,Bracknell Forest,65-69,87,157,-70
E06000036,Bracknell Forest,70-74,87,95,-8
E06000036,Bracknell Forest,75-79,48,69,-21
E06000036,Bracknell Forest,80-84,55,57,-2
E06000036,Bracknell Forest,85-89,55,49,6
E06000036,Bracknell Forest,90+,43,39,4
E08000032,Bradford,0-4,1354,1283,71
E08000032,Bradford,05-Sep,873,1082,-209
E08000032,Bradford,41913,806,793,13
E08000032,Bradford,15-19,995,2007,-1012
E08000032,Bradford,20-24,3484,3489,-5
E08000032,Bradford,25-29,2355,2554,-199
E08000032,Bradford,30-34,1816,1935,-119
E08000032,Bradford,35-39,1376,1463,-87
E08000032,Bradford,40-44,879,1003,-124
E08000032,Bradford,45-49,828,888,-60
E08000032,Bradford,50-54,696,749,-53
E08000032,Bradford,55-59,565,659,-94
E08000032,Bradford,60-64,407,564,-157
E08000032,Bradford,65-69,272,414,-142
E08000032,Bradford,70-74,264,319,-55
E08000032,Bradford,75-79,152,138,14
E08000032,Bradford,80-84,135,129,6
E08000032,Bradford,85-89,94,118,-24
E08000032,Bradford,90+,102,82,20
E07000067,Braintree,0-4,515,491,24
E07000067,Braintree,05-Sep,329,326,3
E07000067,Braintree,41913,262,303,-41
E07000067,Braintree,15-19,268,766,-498
E07000067,Braintree,20-24,1002,877,125
E07000067,Braintree,25-29,970,936,34
E07000067,Braintree,30-34,767,679,88
E07000067,Braintree,35-39,542,506,36
E07000067,Braintree,40-44,433,395,38
E07000067,Braintree,45-49,419,402,17
E07000067,Braintree,50-54,416,406,10
E07000067,Braintree,55-59,331,372,-41
E07000067,Braintree,60-64,252,292,-40
E07000067,Braintree,65-69,208,242,-34
E07000067,Braintree,70-74,173,177,-4
E07000067,Braintree,75-79,116,94,22
E07000067,Braintree,80-84,116,75,41
E07000067,Braintree,85-89,100,80,20
E07000067,Braintree,90+,93,56,37
E07000143,Breckland,0-4,418,328,90
E07000143,Breckland,05-Sep,329,335,-6
E07000143,Breckland,41913,302,313,-11
E07000143,Breckland,15-19,319,640,-321
E07000143,Breckland,20-24,933,859,74
E07000143,Breckland,25-29,785,693,92
E07000143,Breckland,30-34,631,566,65
E07000143,Breckland,35-39,462,408,54
E07000143,Breckland,40-44,448,351,97
E07000143,Breckland,45-49,452,346,106
E07000143,Breckland,50-54,440,359,81
E07000143,Breckland,55-59,497,289,208
E07000143,Breckland,60-64,520,210,310
E07000143,Breckland,65-69,331,241,90
E07000143,Breckland,70-74,238,199,39
E07000143,Breckland,75-79,144,147,-3
E07000143,Breckland,80-84,148,125,23
E07000143,Breckland,85-89,124,91,33
E07000143,Breckland,90+,91,68,23
E09000005,Brent,0-4,1332,2324,-992
E09000005,Brent,05-Sep,930,1523,-593
E09000005,Brent,41913,665,1082,-417
E09000005,Brent,15-19,1220,1662,-442
E09000005,Brent,20-24,4761,4047,714
E09000005,Brent,25-29,3949,4631,-682
E09000005,Brent,30-34,3333,4791,-1458
E09000005,Brent,35-39,2308,3435,-1127
E09000005,Brent,40-44,1506,2128,-622
E09000005,Brent,45-49,1034,1405,-371
E09000005,Brent,50-54,772,1001,-229
E09000005,Brent,55-59,600,703,-103
E09000005,Brent,60-64,327,527,-200
E09000005,Brent,65-69,202,329,-127
E09000005,Brent,70-74,168,188,-20
E09000005,Brent,75-79,96,147,-51
E09000005,Brent,80-84,86,126,-40
E09000005,Brent,85-89,72,98,-26
E09000005,Brent,90+,49,60,-11
E07000068,Brentwood,0-4,306,256,50
E07000068,Brentwood,05-Sep,162,132,30
E07000068,Brentwood,41913,164,133,31
E07000068,Brentwood,15-19,153,460,-307
E07000068,Brentwood,20-24,781,542,239
E07000068,Brentwood,25-29,695,697,-2
E07000068,Brentwood,30-34,602,560,42
E07000068,Brentwood,35-39,413,349,64
E07000068,Brentwood,40-44,256,227,29
E07000068,Brentwood,45-49,214,244,-30
E07000068,Brentwood,50-54,190,220,-30
E07000068,Brentwood,55-59,141,237,-96
E07000068,Brentwood,60-64,93,191,-98
E07000068,Brentwood,65-69,76,116,-40
E07000068,Brentwood,70-74,75,78,-3
E07000068,Brentwood,75-79,44,70,-26
E07000068,Brentwood,80-84,51,59,-8
E07000068,Brentwood,85-89,48,60,-12
E07000068,Brentwood,90+,68,43,25
E06000043,Brighton and Hove,0-4,554,850,-296
E06000043,Brighton and Hove,05-Sep,386,513,-127
E06000043,Brighton and Hove,41913,332,347,-15
E06000043,Brighton and Hove,15-19,4115,1148,2967
E06000043,Brighton and Hove,20-24,6733,7205,-472
E06000043,Brighton and Hove,25-29,3011,3382,-371
E06000043,Brighton and Hove,30-34,2063,2422,-359
E06000043,Brighton and Hove,35-39,1426,1655,-229
E06000043,Brighton and Hove,40-44,867,1225,-358
E06000043,Brighton and Hove,45-49,709,979,-270
E06000043,Brighton and Hove,50-54,611,837,-226
E06000043,Brighton and Hove,55-59,428,639,-211
E06000043,Brighton and Hove,60-64,278,452,-174
E06000043,Brighton and Hove,65-69,204,319,-115
E06000043,Brighton and Hove,70-74,141,220,-79
E06000043,Brighton and Hove,75-79,108,143,-35
E06000043,Brighton and Hove,80-84,90,103,-13
E06000043,Brighton and Hove,85-89,71,81,-10
E06000043,Brighton and Hove,90+,91,97,-6
E06000023,"Bristol, City of",0-4,884,1888,-1004
E06000023,"Bristol, City of",05-Sep,527,1141,-614
E06000023,"Bristol, City of",41913,377,683,-306
E06000023,"Bristol, City of",15-19,4902,1443,3459
E06000023,"Bristol, City of",20-24,11003,9938,1065
E06000023,"Bristol, City of",25-29,6828,5993,835
E06000023,"Bristol, City of",30-34,3944,4368,-424
E06000023,"Bristol, City of",35-39,2144,3023,-879
E06000023,"Bristol, City of",40-44,1107,1699,-592
E06000023,"Bristol, City of",45-49,867,1202,-335
E06000023,"Bristol, City of",50-54,631,956,-325
E06000023,"Bristol, City of",55-59,445,819,-374
E06000023,"Bristol, City of",60-64,296,609,-313
E06000023,"Bristol, City of",65-69,206,419,-213
E06000023,"Bristol, City of",70-74,146,323,-177
E06000023,"Bristol, City of",75-79,98,190,-92
E06000023,"Bristol, City of",80-84,102,130,-28
E06000023,"Bristol, City of",85-89,106,128,-22
E06000023,"Bristol, City of",90+,72,146,-74
E07000144,Broadland,0-4,419,311,108
E07000144,Broadland,05-Sep,408,208,200
E07000144,Broadland,41913,290,215,75
E07000144,Broadland,15-19,306,676,-370
E07000144,Broadland,20-24,970,904,66
E07000144,Broadland,25-29,923,795,128
E07000144,Broadland,30-34,794,555,239
E07000144,Broadland,35-39,643,446,197
E07000144,Broadland,40-44,483,333,150
E07000144,Broadland,45-49,403,347,56
E07000144,Broadland,50-54,407,374,33
E07000144,Broadland,55-59,364,258,106
E07000144,Broadland,60-64,289,243,46
E07000144,Broadland,65-69,250,199,51
E07000144,Broadland,70-74,248,165,83
E07000144,Broadland,75-79,144,113,31
E07000144,Broadland,80-84,115,86,29
E07000144,Broadland,85-89,114,84,30
E07000144,Broadland,90+,114,105,9
E09000006,Bromley,0-4,1547,1336,211
E09000006,Bromley,05-Sep,863,808,55
E09000006,Bromley,41913,659,661,-2
E09000006,Bromley,15-19,511,1929,-1418
E09000006,Bromley,20-24,2973,2186,787
E09000006,Bromley,25-29,2621,2459,162
E09000006,Bromley,30-34,2908,2334,574
E09000006,Bromley,35-39,2183,1820,363
E09000006,Bromley,40-44,1239,1168,71
E09000006,Bromley,45-49,853,949,-96
E09000006,Bromley,50-54,670,913,-243
E09000006,Bromley,55-59,455,712,-257
E09000006,Bromley,60-64,298,572,-274
E09000006,Bromley,65-69,220,465,-245
E09000006,Bromley,70-74,179,300,-121
E09000006,Bromley,75-79,119,168,-49
E09000006,Bromley,80-84,126,134,-8
E09000006,Bromley,85-89,105,194,-89
E09000006,Bromley,90+,87,168,-81
E07000234,Bromsgrove,0-4,481,257,224
E07000234,Bromsgrove,05-Sep,376,182,194
E07000234,Bromsgrove,41913,318,186,132
E07000234,Bromsgrove,15-19,216,644,-428
E07000234,Bromsgrove,20-24,916,717,199
E07000234,Bromsgrove,25-29,712,665,47
E07000234,Bromsgrove,30-34,697,483,214
E07000234,Bromsgrove,35-39,587,335,252
E07000234,Bromsgrove,40-44,385,250,135
E07000234,Bromsgrove,45-49,313,291,22
E07000234,Bromsgrove,50-54,292,259,33
E07000234,Bromsgrove,55-59,196,218,-22
E07000234,Bromsgrove,60-64,197,196,1
E07000234,Bromsgrove,65-69,145,167,-22
E07000234,Bromsgrove,70-74,154,132,22
E07000234,Bromsgrove,75-79,110,80,30
E07000234,Bromsgrove,80-84,100,86,14
E07000234,Bromsgrove,85-89,102,79,23
E07000234,Bromsgrove,90+,110,77,33
E07000095,Broxbourne,0-4,470,513,-43
E07000095,Broxbourne,05-Sep,324,372,-48
E07000095,Broxbourne,41913,244,216,28
E07000095,Broxbourne,15-19,196,504,-308
E07000095,Broxbourne,20-24,790,553,237
E07000095,Broxbourne,25-29,723,761,-38
E07000095,Broxbourne,30-34,790,646,144
E07000095,Broxbourne,35-39,569,534,35
E07000095,Broxbourne,40-44,351,351,0
E07000095,Broxbourne,45-49,293,316,-23
E07000095,Broxbourne,50-54,261,302,-41
E07000095,Broxbourne,55-59,162,227,-65
E07000095,Broxbourne,60-64,120,179,-59
E07000095,Broxbourne,65-69,109,133,-24
E07000095,Broxbourne,70-74,73,108,-35
E07000095,Broxbourne,75-79,36,60,-24
E07000095,Broxbourne,80-84,42,55,-13
E07000095,Broxbourne,85-89,26,63,-37
E07000095,Broxbourne,90+,19,67,-48
E07000172,Broxtowe,0-4,440,434,6
E07000172,Broxtowe,05-Sep,321,337,-16
E07000172,Broxtowe,41913,249,203,46
E07000172,Broxtowe,15-19,673,632,41
E07000172,Broxtowe,20-24,1958,1658,300
E07000172,Broxtowe,25-29,1367,1276,91
E07000172,Broxtowe,30-34,884,912,-28
E07000172,Broxtowe,35-39,564,581,-17
E07000172,Broxtowe,40-44,343,332,11
E07000172,Broxtowe,45-49,356,298,58
E07000172,Broxtowe,50-54,263,297,-34
E07000172,Broxtowe,55-59,221,257,-36
E07000172,Broxtowe,60-64,137,157,-20
E07000172,Broxtowe,65-69,145,124,21
E07000172,Broxtowe,70-74,131,103,28
E07000172,Broxtowe,75-79,79,67,12
E07000172,Broxtowe,80-84,86,82,4
E07000172,Broxtowe,85-89,80,66,14
E07000172,Broxtowe,90+,50,44,6
E07000117,Burnley,0-4,272,250,22
E07000117,Burnley,05-Sep,195,183,12
E07000117,Burnley,41913,134,129,5
E07000117,Burnley,15-19,179,353,-174
E07000117,Burnley,20-24,590,511,79
E07000117,Burnley,25-29,483,456,27
E07000117,Burnley,30-34,397,362,35
E07000117,Burnley,35-39,284,281,3
E07000117,Burnley,40-44,193,174,19
E07000117,Burnley,45-49,201,187,14
E07000117,Burnley,50-54,168,195,-27
E07000117,Burnley,55-59,148,153,-5
E07000117,Burnley,60-64,110,101,9
E07000117,Burnley,65-69,86,81,5
E07000117,Burnley,70-74,77,58,19
E07000117,Burnley,75-79,47,40,7
E07000117,Burnley,80-84,33,35,-2
E07000117,Burnley,85-89,38,32,6
E07000117,Burnley,90+,25,22,3
E08000002,Bury,0-4,611,575,36
E08000002,Bury,05-Sep,411,421,-10
E08000002,Bury,41913,281,338,-57
E08000002,Bury,15-19,351,885,-534
E08000002,Bury,20-24,1541,1116,425
E08000002,Bury,25-29,1361,1216,145
E08000002,Bury,30-34,1140,991,149
E08000002,Bury,35-39,726,679,47
E08000002,Bury,40-44,457,408,49
E08000002,Bury,45-49,368,428,-60
E08000002,Bury,50-54,325,421,-96
E08000002,Bury,55-59,207,324,-117
E08000002,Bury,60-64,170,246,-76
E08000002,Bury,65-69,133,181,-48
E08000002,Bury,70-74,77,130,-53
E08000002,Bury,75-79,77,77,0
E08000002,Bury,80-84,52,60,-8
E08000002,Bury,85-89,81,42,39
E08000002,Bury,90+,46,46,0
E08000033,Calderdale,0-4,524,558,-34
E08000033,Calderdale,05-Sep,361,397,-36
E08000033,Calderdale,41913,291,262,29
E08000033,Calderdale,15-19,280,924,-644
E08000033,Calderdale,20-24,1494,1154,340
E08000033,Calderdale,25-29,1100,1011,89
E08000033,Calderdale,30-34,871,805,66
E08000033,Calderdale,35-39,691,613,78
E08000033,Calderdale,40-44,502,418,84
E08000033,Calderdale,45-49,440,412,28
E08000033,Calderdale,50-54,397,418,-21
E08000033,Calderdale,55-59,274,325,-51
E08000033,Calderdale,60-64,231,291,-60
E08000033,Calderdale,65-69,184,205,-21
E08000033,Calderdale,70-74,144,146,-2
E08000033,Calderdale,75-79,63,63,0
E08000033,Calderdale,80-84,52,58,-6
E08000033,Calderdale,85-89,40,51,-11
E08000033,Calderdale,90+,34,43,-9
E07000008,Cambridge,0-4,499,566,-67
E07000008,Cambridge,05-Sep,345,338,7
E07000008,Cambridge,41913,258,247,11
E07000008,Cambridge,15-19,3433,729,2704
E07000008,Cambridge,20-24,4597,6091,-1494
E07000008,Cambridge,25-29,2522,3393,-871
E07000008,Cambridge,30-34,1487,2107,-620
E07000008,Cambridge,35-39,943,1284,-341
E07000008,Cambridge,40-44,598,720,-122
E07000008,Cambridge,45-49,432,442,-10
E07000008,Cambridge,50-54,316,323,-7
E07000008,Cambridge,55-59,223,233,-10
E07000008,Cambridge,60-64,162,201,-39
E07000008,Cambridge,65-69,102,156,-54
E07000008,Cambridge,70-74,88,83,5
E07000008,Cambridge,75-79,48,53,-5
E07000008,Cambridge,80-84,63,50,13
E07000008,Cambridge,85-89,69,43,26
E07000008,Cambridge,90+,56,46,10
E09000007,Camden,0-4,553,1112,-559
E09000007,Camden,05-Sep,321,526,-205
E09000007,Camden,41913,225,418,-193
E09000007,Camden,15-19,2102,897,1205
E09000007,Camden,20-24,6482,6230,252
E09000007,Camden,25-29,4722,5013,-291
E09000007,Camden,30-34,3240,4343,-1103
E09000007,Camden,35-39,1810,2791,-981
E09000007,Camden,40-44,1011,1578,-567
E09000007,Camden,45-49,691,1019,-328
E09000007,Camden,50-54,531,678,-147
E09000007,Camden,55-59,366,441,-75
E09000007,Camden,60-64,218,298,-80
E09000007,Camden,65-69,154,215,-61
E09000007,Camden,70-74,97,161,-64
E09000007,Camden,75-79,72,109,-37
E09000007,Camden,80-84,36,87,-51
E09000007,Camden,85-89,25,74,-49
E09000007,Camden,90+,14,76,-62
E07000192,Cannock Chase,0-4,330,309,21
E07000192,Cannock Chase,05-Sep,253,219,34
E07000192,Cannock Chase,41913,152,147,5
E07000192,Cannock Chase,15-19,226,328,-102
E07000192,Cannock Chase,20-24,671,511,160
E07000192,Cannock Chase,25-29,663,518,145
E07000192,Cannock Chase,30-34,550,352,198
E07000192,Cannock Chase,35-39,384,302,82
E07000192,Cannock Chase,40-44,223,186,37
E07000192,Cannock Chase,45-49,289,198,91
E07000192,Cannock Chase,50-54,225,206,19
E07000192,Cannock Chase,55-59,176,171,5
E07000192,Cannock Chase,60-64,135,131,4
E07000192,Cannock Chase,65-69,101,87,14
E07000192,Cannock Chase,70-74,77,73,4
E07000192,Cannock Chase,75-79,69,45,24
E07000192,Cannock Chase,80-84,54,48,6
E07000192,Cannock Chase,85-89,44,38,6
E07000192,Cannock Chase,90+,41,44,-3
E07000106,Canterbury,0-4,389,363,26
E07000106,Canterbury,05-Sep,289,230,59
E07000106,Canterbury,41913,333,244,89
E07000106,Canterbury,15-19,3637,873,2764
E07000106,Canterbury,20-24,3747,6761,-3014
E07000106,Canterbury,25-29,1011,1820,-809
E07000106,Canterbury,30-34,695,879,-184
E07000106,Canterbury,35-39,573,579,-6
E07000106,Canterbury,40-44,419,376,43
E07000106,Canterbury,45-49,405,369,36
E07000106,Canterbury,50-54,410,324,86
E07000106,Canterbury,55-59,353,295,58
E07000106,Canterbury,60-64,329,253,76
E07000106,Canterbury,65-69,261,196,65
E07000106,Canterbury,70-74,227,122,105
E07000106,Canterbury,75-79,134,76,58
E07000106,Canterbury,80-84,123,93,30
E07000106,Canterbury,85-89,120,74,46
E07000106,Canterbury,90+,90,66,24
E07000028,Carlisle,0-4,196,198,-2
E07000028,Carlisle,05-Sep,133,147,-14
E07000028,Carlisle,41913,134,123,11
E07000028,Carlisle,15-19,318,372,-54
E07000028,Carlisle,20-24,881,926,-45
E07000028,Carlisle,25-29,593,518,75
E07000028,Carlisle,30-34,339,337,2
E07000028,Carlisle,35-39,274,235,39
E07000028,Carlisle,40-44,205,163,42
E07000028,Carlisle,45-49,207,181,26
E07000028,Carlisle,50-54,212,147,65
E07000028,Carlisle,55-59,160,142,18
E07000028,Carlisle,60-64,141,109,32
E07000028,Carlisle,65-69,130,80,50
E07000028,Carlisle,70-74,108,80,28
E07000028,Carlisle,75-79,45,47,-2
E07000028,Carlisle,80-84,45,36,9
E07000028,Carlisle,85-89,27,24,3
E07000028,Carlisle,90+,28,16,12
E07000069,Castle Point,0-4,350,262,88
E07000069,Castle Point,05-Sep,304,188,116
E07000069,Castle Point,41913,233,137,96
E07000069,Castle Point,15-19,188,428,-240
E07000069,Castle Point,20-24,529,466,63
E07000069,Castle Point,25-29,535,493,42
E07000069,Castle Point,30-34,451,397,54
E07000069,Castle Point,35-39,396,279,117
E07000069,Castle Point,40-44,243,220,23
E07000069,Castle Point,45-49,272,216,56
E07000069,Castle Point,50-54,200,239,-39
E07000069,Castle Point,55-59,207,215,-8
E07000069,Castle Point,60-64,141,157,-16
E07000069,Castle Point,65-69,120,118,2
E07000069,Castle Point,70-74,132,122,10
E07000069,Castle Point,75-79,90,72,18
E07000069,Castle Point,80-84,54,64,-10
E07000069,Castle Point,85-89,65,52,13
E07000069,Castle Point,90+,48,47,1
E06000056,Central Bedfordshire,0-4,1376,935,441
E06000056,Central Bedfordshire,05-Sep,844,744,100
E06000056,Central Bedfordshire,41913,607,551,56
E06000056,Central Bedfordshire,15-19,525,1418,-893
E06000056,Central Bedfordshire,20-24,2379,1864,515
E06000056,Central Bedfordshire,25-29,2441,1927,514
E06000056,Central Bedfordshire,30-34,2316,1524,792
E06000056,Central Bedfordshire,35-39,1655,1129,526
E06000056,Central Bedfordshire,40-44,1047,835,212
E06000056,Central Bedfordshire,45-49,840,805,35
E06000056,Central Bedfordshire,50-54,765,805,-40
E06000056,Central Bedfordshire,55-59,644,704,-60
E06000056,Central Bedfordshire,60-64,481,533,-52
E06000056,Central Bedfordshire,65-69,331,404,-73
E06000056,Central Bedfordshire,70-74,222,269,-47
E06000056,Central Bedfordshire,75-79,152,142,10
E06000056,Central Bedfordshire,80-84,133,141,-8
E06000056,Central Bedfordshire,85-89,103,100,3
E06000056,Central Bedfordshire,90+,83,76,7
E07000130,Charnwood,0-4,535,420,115
E07000130,Charnwood,05-Sep,381,288,93
E07000130,Charnwood,41913,315,225,90
E07000130,Charnwood,15-19,3424,1089,2335
E07000130,Charnwood,20-24,3764,5861,-2097
E07000130,Charnwood,25-29,1438,1606,-168
E07000130,Charnwood,30-34,1115,930,185
E07000130,Charnwood,35-39,751,567,184
E07000130,Charnwood,40-44,516,421,95
E07000130,Charnwood,45-49,465,356,109
E07000130,Charnwood,50-54,421,309,112
E07000130,Charnwood,55-59,296,260,36
E07000130,Charnwood,60-64,242,200,42
E07000130,Charnwood,65-69,191,179,12
E07000130,Charnwood,70-74,115,120,-5
E07000130,Charnwood,75-79,78,95,-17
E07000130,Charnwood,80-84,86,69,17
E07000130,Charnwood,85-89,82,65,17
E07000130,Charnwood,90+,53,76,-23
E07000070,Chelmsford,0-4,628,596,32
E07000070,Chelmsford,05-Sep,416,310,106
E07000070,Chelmsford,41913,348,287,61
E07000070,Chelmsford,15-19,458,945,-487
E07000070,Chelmsford,20-24,1794,1461,333
E07000070,Chelmsford,25-29,1451,1310,141
E07000070,Chelmsford,30-34,1155,1081,74
E07000070,Chelmsford,35-39,841,733,108
E07000070,Chelmsford,40-44,580,498,82
E07000070,Chelmsford,45-49,479,405,74
E07000070,Chelmsford,50-54,403,353,50
E07000070,Chelmsford,55-59,305,363,-58
E07000070,Chelmsford,60-64,185,313,-128
E07000070,Chelmsford,65-69,193,215,-22
E07000070,Chelmsford,70-74,138,166,-28
E07000070,Chelmsford,75-79,87,102,-15
E07000070,Chelmsford,80-84,86,84,2
E07000070,Chelmsford,85-89,97,65,32
E07000070,Chelmsford,90+,71,84,-13
E07000078,Cheltenham,0-4,306,430,-124
E07000078,Cheltenham,05-Sep,237,286,-49
E07000078,Cheltenham,41913,273,225,48
E07000078,Cheltenham,15-19,1128,773,355
E07000078,Cheltenham,20-24,2168,2259,-91
E07000078,Cheltenham,25-29,1186,1265,-79
E07000078,Cheltenham,30-34,837,868,-31
E07000078,Cheltenham,35-39,531,722,-191
E07000078,Cheltenham,40-44,337,380,-43
E07000078,Cheltenham,45-49,306,331,-25
E07000078,Cheltenham,50-54,286,335,-49
E07000078,Cheltenham,55-59,251,268,-17
E07000078,Cheltenham,60-64,205,213,-8
E07000078,Cheltenham,65-69,125,161,-36
E07000078,Cheltenham,70-74,132,118,14
E07000078,Cheltenham,75-79,81,76,5
E07000078,Cheltenham,80-84,67,53,14
E07000078,Cheltenham,85-89,95,56,39
E07000078,Cheltenham,90+,61,49,12
E07000177,Cherwell,0-4,631,466,165
E07000177,Cherwell,05-Sep,418,399,19
E07000177,Cherwell,41913,299,315,-16
E07000177,Cherwell,15-19,294,860,-566
E07000177,Cherwell,20-24,1401,1137,264
E07000177,Cherwell,25-29,1265,1118,147
E07000177,Cherwell,30-34,1213,871,342
E07000177,Cherwell,35-39,864,674,190
E07000177,Cherwell,40-44,538,432,106
E07000177,Cherwell,45-49,427,396,31
E07000177,Cherwell,50-54,394,386,8
E07000177,Cherwell,55-59,293,319,-26
E07000177,Cherwell,60-64,269,232,37
E07000177,Cherwell,65-69,179,203,-24
E07000177,Cherwell,70-74,146,141,5
E07000177,Cherwell,75-79,100,84,16
E07000177,Cherwell,80-84,86,65,21
E07000177,Cherwell,85-89,69,66,3
E07000177,Cherwell,90+,81,37,44
E06000049,Cheshire East,0-4,1069,650,419
E06000049,Cheshire East,05-Sep,728,461,267
E06000049,Cheshire East,41913,579,385,194
E06000049,Cheshire East,15-19,659,1968,-1309
E06000049,Cheshire East,20-24,3158,2839,319
E06000049,Cheshire East,25-29,2175,1942,233
E06000049,Cheshire East,30-34,1851,1391,460
E06000049,Cheshire East,35-39,1366,933,433
E06000049,Cheshire East,40-44,943,702,241
E06000049,Cheshire East,45-49,913,639,274
E06000049,Cheshire East,50-54,859,659,200
E06000049,Cheshire East,55-59,737,652,85
E06000049,Cheshire East,60-64,637,449,188
E06000049,Cheshire East,65-69,513,350,163
E06000049,Cheshire East,70-74,374,284,90
E06000049,Cheshire East,75-79,216,163,53
E06000049,Cheshire East,80-84,209,141,68
E06000049,Cheshire East,85-89,161,117,44
E06000049,Cheshire East,90+,131,104,27
E06000050,Cheshire West and Chester,0-4,978,659,319
E06000050,Cheshire West and Chester,05-Sep,694,442,252
E06000050,Cheshire West and Chester,41913,518,329,189
E06000050,Cheshire West and Chester,15-19,1650,1595,55
E06000050,Cheshire West and Chester,20-24,3630,3759,-129
E06000050,Cheshire West and Chester,25-29,2082,2224,-142
E06000050,Cheshire West and Chester,30-34,1659,1398,261
E06000050,Cheshire West and Chester,35-39,1270,849,421
E06000050,Cheshire West and Chester,40-44,873,634,239
E06000050,Cheshire West and Chester,45-49,802,602,200
E06000050,Cheshire West and Chester,50-54,702,601,101
E06000050,Cheshire West and Chester,55-59,671,523,148
E06000050,Cheshire West and Chester,60-64,528,430,98
E06000050,Cheshire West and Chester,65-69,413,306,107
E06000050,Cheshire West and Chester,70-74,342,232,110
E06000050,Cheshire West and Chester,75-79,200,154,46
E06000050,Cheshire West and Chester,80-84,134,123,11
E06000050,Cheshire West and Chester,85-89,135,106,29
E06000050,Cheshire West and Chester,90+,124,77,47
E07000034,Chesterfield,0-4,258,259,-1
E07000034,Chesterfield,05-Sep,221,176,45
E07000034,Chesterfield,41913,161,161,0
E07000034,Chesterfield,15-19,234,437,-203
E07000034,Chesterfield,20-24,809,646,163
E07000034,Chesterfield,25-29,635,613,22
E07000034,Chesterfield,30-34,560,430,130
E07000034,Chesterfield,35-39,353,360,-7
E07000034,Chesterfield,40-44,246,254,-8
E07000034,Chesterfield,45-49,242,228,14
E07000034,Chesterfield,50-54,230,208,22
E07000034,Chesterfield,55-59,183,174,9
E07000034,Chesterfield,60-64,146,148,-2
E07000034,Chesterfield,65-69,98,84,14
E07000034,Chesterfield,70-74,82,86,-4
E07000034,Chesterfield,75-79,58,45,13
E07000034,Chesterfield,80-84,66,32,34
E07000034,Chesterfield,85-89,50,37,13
E07000034,Chesterfield,90+,29,45,-16
E07000225,Chichester,0-4,433,323,110
E07000225,Chichester,05-Sep,343,266,77
E07000225,Chichester,41913,261,340,-79
E07000225,Chichester,15-19,802,690,112
E07000225,Chichester,20-24,1449,1862,-413
E07000225,Chichester,25-29,788,895,-107
E07000225,Chichester,30-34,690,616,74
E07000225,Chichester,35-39,517,438,79
E07000225,Chichester,40-44,376,343,33
E07000225,Chichester,45-49,443,379,64
E07000225,Chichester,50-54,460,345,115
E07000225,Chichester,55-59,474,312,162
E07000225,Chichester,60-64,433,290,143
E07000225,Chichester,65-69,323,213,110
E07000225,Chichester,70-74,261,211,50
E07000225,Chichester,75-79,156,126,30
E07000225,Chichester,80-84,132,117,15
E07000225,Chichester,85-89,130,86,44
E07000225,Chichester,90+,123,88,35
E07000005,Chiltern,0-4,464,278,186
E07000005,Chiltern,05-Sep,392,215,177
E07000005,Chiltern,41913,288,242,46
E07000005,Chiltern,15-19,176,800,-624
E07000005,Chiltern,20-24,1176,860,316
E07000005,Chiltern,25-29,624,720,-96
E07000005,Chiltern,30-34,738,568,170
E07000005,Chiltern,35-39,682,410,272
E07000005,Chiltern,40-44,526,292,234
E07000005,Chiltern,45-49,331,269,62
E07000005,Chiltern,50-54,227,277,-50
E07000005,Chiltern,55-59,197,255,-58
E07000005,Chiltern,60-64,131,217,-86
E07000005,Chiltern,65-69,92,181,-89
E07000005,Chiltern,70-74,82,133,-51
E07000005,Chiltern,75-79,77,66,11
E07000005,Chiltern,80-84,71,74,-3
E07000005,Chiltern,85-89,80,65,15
E07000005,Chiltern,90+,55,53,2
E07000118,Chorley,0-4,425,296,129
E07000118,Chorley,05-Sep,287,217,70
E07000118,Chorley,41913,241,167,74
E07000118,Chorley,15-19,229,523,-294
E07000118,Chorley,20-24,842,597,245
E07000118,Chorley,25-29,760,658,102
E07000118,Chorley,30-34,655,507,148
E07000118,Chorley,35-39,512,344,168
E07000118,Chorley,40-44,365,280,85
E07000118,Chorley,45-49,363,267,96
E07000118,Chorley,50-54,340,228,112
E07000118,Chorley,55-59,225,210,15
E07000118,Chorley,60-64,177,144,33
E07000118,Chorley,65-69,157,125,32
E07000118,Chorley,70-74,114,100,14
E07000118,Chorley,75-79,59,55,4
E07000118,Chorley,80-84,79,63,16
E07000118,Chorley,85-89,65,43,22
E07000118,Chorley,90+,55,29,26
E07000048,Christchurch,0-4,193,144,49
E07000048,Christchurch,05-Sep,159,80,79
E07000048,Christchurch,41913,165,110,55
E07000048,Christchurch,15-19,112,219,-107
E07000048,Christchurch,20-24,412,341,71
E07000048,Christchurch,25-29,329,339,-10
E07000048,Christchurch,30-34,323,237,86
E07000048,Christchurch,35-39,263,193,70
E07000048,Christchurch,40-44,170,168,2
E07000048,Christchurch,45-49,244,162,82
E07000048,Christchurch,50-54,197,168,29
E07000048,Christchurch,55-59,206,134,72
E07000048,Christchurch,60-64,210,113,97
E07000048,Christchurch,65-69,210,78,132
E07000048,Christchurch,70-74,152,103,49
E07000048,Christchurch,75-79,97,74,23
E07000048,Christchurch,80-84,83,73,10
E07000048,Christchurch,85-89,56,83,-27
E07000048,Christchurch,90+,50,90,-40
E09000001,City of London,0-4,11,55,-44
E09000001,City of London,05-Sep,9,13,-4
E09000001,City of London,41913,7,17,-10
E09000001,City of London,15-19,12,25,-13
E09000001,City of London,20-24,214,115,99
E09000001,City of London,25-29,221,202,19
E09000001,City of London,30-34,142,161,-19
E09000001,City of London,35-39,100,124,-24
E09000001,City of London,40-44,48,88,-40
E09000001,City of London,45-49,39,54,-15
E09000001,City of London,50-54,40,45,-5
E09000001,City of London,55-59,42,36,6
E09000001,City of London,60-64,14,27,-13
E09000001,City of London,65-69,15,16,-1
E09000001,City of London,70-74,8,17,-9
E09000001,City of London,75-79,6,6,0
E09000001,City of London,80-84,3,6,-3
E09000001,City of London,85-89,0,2,-2
E09000001,City of London,90+,0,2,-2
E07000071,Colchester,0-4,780,754,26
E07000071,Colchester,05-Sep,567,478,89
E07000071,Colchester,41913,424,352,72
E07000071,Colchester,15-19,1912,894,1018
E07000071,Colchester,20-24,2578,3276,-698
E07000071,Colchester,25-29,1635,1579,56
E07000071,Colchester,30-34,1209,998,211
E07000071,Colchester,35-39,817,698,119
E07000071,Colchester,40-44,575,537,38
E07000071,Colchester,45-49,511,483,28
E07000071,Colchester,50-54,434,435,-1
E07000071,Colchester,55-59,298,368,-70
E07000071,Colchester,60-64,274,292,-18
E07000071,Colchester,65-69,215,213,2
E07000071,Colchester,70-74,189,171,18
E07000071,Colchester,75-79,102,82,20
E07000071,Colchester,80-84,68,79,-11
E07000071,Colchester,85-89,92,63,29
E07000071,Colchester,90+,60,57,3
E07000029,Copeland,0-4,79,109,-30
E07000029,Copeland,05-Sep,72,93,-21
E07000029,Copeland,41913,53,65,-12
E07000029,Copeland,15-19,87,230,-143
E07000029,Copeland,20-24,329,249,80
E07000029,Copeland,25-29,261,262,-1
E07000029,Copeland,30-34,131,169,-38
E07000029,Copeland,35-39,126,117,9
E07000029,Copeland,40-44,96,98,-2
E07000029,Copeland,45-49,119,96,23
E07000029,Copeland,50-54,121,88,33
E07000029,Copeland,55-59,98,69,29
E07000029,Copeland,60-64,98,69,29
E07000029,Copeland,65-69,46,55,-9
E07000029,Copeland,70-74,32,43,-11
E07000029,Copeland,75-79,11,25,-14
E07000029,Copeland,80-84,2,26,-24
E07000029,Copeland,85-89,9,32,-23
E07000029,Copeland,90+,10,15,-5
E07000150,Corby,0-4,254,184,70
E07000150,Corby,05-Sep,208,124,84
E07000150,Corby,41913,173,130,43
E07000150,Corby,15-19,131,313,-182
E07000150,Corby,20-24,429,397,32
E07000150,Corby,25-29,419,326,93
E07000150,Corby,30-34,400,260,140
E07000150,Corby,35-39,322,197,125
E07000150,Corby,40-44,214,153,61
E07000150,Corby,45-49,189,160,29
E07000150,Corby,50-54,174,141,33
E07000150,Corby,55-59,119,106,13
E07000150,Corby,60-64,86,100,-14
E07000150,Corby,65-69,53,74,-21
E07000150,Corby,70-74,33,45,-12
E07000150,Corby,75-79,19,21,-2
E07000150,Corby,80-84,28,22,6
E07000150,Corby,85-89,28,16,12
E07000150,Corby,90+,19,12,7
E06000052,Cornwall,0-4,1155,654,501
E06000052,Cornwall,05-Sep,988,582,406
E06000052,Cornwall,41913,791,471,320
E06000052,Cornwall,15-19,1858,1978,-120
E06000052,Cornwall,20-24,4493,5053,-560
E06000052,Cornwall,25-29,2532,2398,134
E06000052,Cornwall,30-34,1818,1342,476
E06000052,Cornwall,35-39,1544,911,633
E06000052,Cornwall,40-44,1219,779,440
E06000052,Cornwall,45-49,1372,833,539
E06000052,Cornwall,50-54,1493,841,652
E06000052,Cornwall,55-59,1578,772,806
E06000052,Cornwall,60-64,1388,687,701
E06000052,Cornwall,65-69,1022,653,369
E06000052,Cornwall,70-74,668,566,102
E06000052,Cornwall,75-79,342,358,-16
E06000052,Cornwall,80-84,251,247,4
E06000052,Cornwall,85-89,189,178,11
E06000052,Cornwall,90+,141,102,39
E07000079,Cotswold,0-4,388,208,180
E07000079,Cotswold,05-Sep,336,214,122
E07000079,Cotswold,41913,248,205,43
E07000079,Cotswold,15-19,419,526,-107
E07000079,Cotswold,20-24,1107,1108,-1
E07000079,Cotswold,25-29,670,623,47
E07000079,Cotswold,30-34,582,384,198
E07000079,Cotswold,35-39,515,285,230
E07000079,Cotswold,40-44,407,235,172
E07000079,Cotswold,45-49,357,304,53
E07000079,Cotswold,50-54,420,312,108
E07000079,Cotswold,55-59,344,299,45
E07000079,Cotswold,60-64,328,214,114
E07000079,Cotswold,65-69,243,167,76
E07000079,Cotswold,70-74,205,113,92
E07000079,Cotswold,75-79,124,78,46
E07000079,Cotswold,80-84,101,73,28
E07000079,Cotswold,85-89,65,69,-4
E07000079,Cotswold,90+,48,34,14
E06000047,County Durham,0-4,1072,861,211
E06000047,County Durham,05-Sep,852,588,264
E06000047,County Durham,41913,679,469,210
E06000047,County Durham,15-19,3582,1834,1748
E06000047,County Durham,20-24,4683,6240,-1557
E06000047,County Durham,25-29,2236,2535,-299
E06000047,County Durham,30-34,1679,1645,34
E06000047,County Durham,35-39,1245,1118,127
E06000047,County Durham,40-44,922,739,183
E06000047,County Durham,45-49,897,731,166
E06000047,County Durham,50-54,899,625,274
E06000047,County Durham,55-59,731,596,135
E06000047,County Durham,60-64,614,413,201
E06000047,County Durham,65-69,469,342,127
E06000047,County Durham,70-74,286,239,47
E06000047,County Durham,75-79,157,138,19
E06000047,County Durham,80-84,108,121,-13
E06000047,County Durham,85-89,94,104,-10
E06000047,County Durham,90+,77,75,2
E08000026,Coventry,0-4,842,1029,-187
E08000026,Coventry,05-Sep,565,692,-127
E08000026,Coventry,41913,362,522,-160
E08000026,Coventry,15-19,5804,1632,4172
E08000026,Coventry,20-24,6394,9731,-3337
E08000026,Coventry,25-29,2147,2833,-686
E08000026,Coventry,30-34,1551,1973,-422
E08000026,Coventry,35-39,1017,1366,-349
E08000026,Coventry,40-44,705,833,-128
E08000026,Coventry,45-49,512,678,-166
E08000026,Coventry,50-54,370,634,-264
E08000026,Coventry,55-59,247,436,-189
E08000026,Coventry,60-64,156,304,-148
E08000026,Coventry,65-69,125,244,-119
E08000026,Coventry,70-74,89,145,-56
E08000026,Coventry,75-79,59,92,-33
E08000026,Coventry,80-84,58,94,-36
E08000026,Coventry,85-89,52,52,0
E08000026,Coventry,90+,42,80,-38
E07000163,Craven,0-4,170,116,54
E07000163,Craven,05-Sep,130,110,20
E07000163,Craven,41913,98,101,-3
E07000163,Craven,15-19,114,350,-236
E07000163,Craven,20-24,475,395,80
E07000163,Craven,25-29,334,310,24
E07000163,Craven,30-34,267,191,76
E07000163,Craven,35-39,203,156,47
E07000163,Craven,40-44,173,121,52
E07000163,Craven,45-49,190,155,35
E07000163,Craven,50-54,196,179,17
E07000163,Craven,55-59,186,183,3
E07000163,Craven,60-64,214,135,79
E07000163,Craven,65-69,143,118,25
E07000163,Craven,70-74,110,102,8
E07000163,Craven,75-79,67,45,22
E07000163,Craven,80-84,48,44,4
E07000163,Craven,85-89,45,36,9
E07000163,Craven,90+,29,35,-6
E07000226,Crawley,0-4,328,400,-72
E07000226,Crawley,05-Sep,239,281,-42
E07000226,Crawley,41913,151,212,-61
E07000226,Crawley,15-19,153,442,-289
E07000226,Crawley,20-24,834,639,195
E07000226,Crawley,25-29,852,701,151
E07000226,Crawley,30-34,717,658,59
E07000226,Crawley,35-39,487,568,-81
E07000226,Crawley,40-44,299,340,-41
E07000226,Crawley,45-49,255,305,-50
E07000226,Crawley,50-54,219,252,-33
E07000226,Crawley,55-59,154,190,-36
E07000226,Crawley,60-64,82,145,-63
E07000226,Crawley,65-69,64,88,-24
E07000226,Crawley,70-74,48,89,-41
E07000226,Crawley,75-79,29,44,-15
E07000226,Crawley,80-84,18,27,-9
E07000226,Crawley,85-89,21,65,-44
E07000226,Crawley,90+,26,50,-24
E09000008,Croydon,0-4,1798,2404,-606
E09000008,Croydon,05-Sep,1045,1610,-565
E09000008,Croydon,41913,815,1146,-331
E09000008,Croydon,15-19,908,2446,-1538
E09000008,Croydon,20-24,3740,3073,667
E09000008,Croydon,25-29,3631,3330,301
E09000008,Croydon,30-34,3337,3358,-21
E09000008,Croydon,35-39,2378,2698,-320
E09000008,Croydon,40-44,1484,1794,-310
E09000008,Croydon,45-49,977,1329,-352
E09000008,Croydon,50-54,904,1123,-219
E09000008,Croydon,55-59,634,896,-262
E09000008,Croydon,60-64,431,628,-197
E09000008,Croydon,65-69,207,473,-266
E09000008,Croydon,70-74,171,362,-191
E09000008,Croydon,75-79,114,173,-59
E09000008,Croydon,80-84,134,175,-41
E09000008,Croydon,85-89,96,145,-49
E09000008,Croydon,90+,93,100,-7
E07000096,Dacorum,0-4,668,495,173
E07000096,Dacorum,05-Sep,348,365,-17
E07000096,Dacorum,41913,245,300,-55
E07000096,Dacorum,15-19,289,879,-590
E07000096,Dacorum,20-24,1390,1025,365
E07000096,Dacorum,25-29,1164,1066,98
E07000096,Dacorum,30-34,1187,900,287
E07000096,Dacorum,35-39,845,689,156
E07000096,Dacorum,40-44,485,497,-12
E07000096,Dacorum,45-49,384,440,-56
E07000096,Dacorum,50-54,286,398,-112
E07000096,Dacorum,55-59,252,335,-83
E07000096,Dacorum,60-64,171,282,-111
E07000096,Dacorum,65-69,129,187,-58
E07000096,Dacorum,70-74,94,125,-31
E07000096,Dacorum,75-79,83,73,10
E07000096,Dacorum,80-84,62,81,-19
E07000096,Dacorum,85-89,70,82,-12
E07000096,Dacorum,90+,60,64,-4
E06000005,Darlington,0-4,266,275,-9
E06000005,Darlington,05-Sep,206,213,-7
E06000005,Darlington,41913,193,153,40
E06000005,Darlington,15-19,231,475,-244
E06000005,Darlington,20-24,722,580,142
E06000005,Darlington,25-29,569,552,17
E06000005,Darlington,30-34,441,385,56
E06000005,Darlington,35-39,314,335,-21
E06000005,Darlington,40-44,240,210,30
E06000005,Darlington,45-49,217,221,-4
E06000005,Darlington,50-54,201,202,-1
E06000005,Darlington,55-59,153,172,-19
E06000005,Darlington,60-64,119,131,-12
E06000005,Darlington,65-69,114,96,18
E06000005,Darlington,70-74,68,59,9
E06000005,Darlington,75-79,54,42,12
E06000005,Darlington,80-84,50,25,25
E06000005,Darlington,85-89,37,31,6
E06000005,Darlington,90+,28,15,13
E07000107,Dartford,0-4,806,615,191
E07000107,Dartford,05-Sep,512,415,97
E07000107,Dartford,41913,468,311,157
E07000107,Dartford,15-19,282,517,-235
E07000107,Dartford,20-24,877,648,229
E07000107,Dartford,25-29,1215,831,384
E07000107,Dartford,30-34,1177,862,315
E07000107,Dartford,35-39,915,657,258
E07000107,Dartford,40-44,522,400,122
E07000107,Dartford,45-49,419,341,78
E07000107,Dartford,50-54,283,338,-55
E07000107,Dartford,55-59,217,277,-60
E07000107,Dartford,60-64,116,191,-75
E07000107,Dartford,65-69,102,142,-40
E07000107,Dartford,70-74,71,96,-25
E07000107,Dartford,75-79,63,64,-1
E07000107,Dartford,80-84,54,48,6
E07000107,Dartford,85-89,60,53,7
E07000107,Dartford,90+,50,47,3
E07000151,Daventry,0-4,431,203,228
E07000151,Daventry,05-Sep,316,168,148
E07000151,Daventry,41913,258,177,81
E07000151,Daventry,15-19,223,493,-270
E07000151,Daventry,20-24,896,593,303
E07000151,Daventry,25-29,759,560,199
E07000151,Daventry,30-34,692,385,307
E07000151,Daventry,35-39,549,275,274
E07000151,Daventry,40-44,376,214,162
E07000151,Daventry,45-49,340,260,80
E07000151,Daventry,50-54,317,280,37
E07000151,Daventry,55-59,262,210,52
E07000151,Daventry,60-64,216,172,44
E07000151,Daventry,65-69,168,149,19
E07000151,Daventry,70-74,123,105,18
E07000151,Daventry,75-79,59,57,2
E07000151,Daventry,80-84,51,70,-19
E07000151,Daventry,85-89,68,64,4
E07000151,Daventry,90+,50,42,8
E06000015,Derby,0-4,719,815,-96
E06000015,Derby,05-Sep,469,626,-157
E06000015,Derby,41913,463,508,-45
E06000015,Derby,15-19,1642,1001,641
E06000015,Derby,20-24,3271,3563,-292
E06000015,Derby,25-29,1911,2157,-246
E06000015,Derby,30-34,1205,1428,-223
E06000015,Derby,35-39,841,1040,-199
E06000015,Derby,40-44,581,707,-126
E06000015,Derby,45-49,486,587,-101
E06000015,Derby,50-54,428,496,-68
E06000015,Derby,55-59,325,403,-78
E06000015,Derby,60-64,231,295,-64
E06000015,Derby,65-69,167,183,-16
E06000015,Derby,70-74,134,143,-9
E06000015,Derby,75-79,63,67,-4
E06000015,Derby,80-84,80,83,-3
E06000015,Derby,85-89,73,78,-5
E06000015,Derby,90+,51,72,-21
E07000035,Derbyshire Dales,0-4,193,114,79
E07000035,Derbyshire Dales,05-Sep,173,97,76
E07000035,Derbyshire Dales,41913,157,98,59
E07000035,Derbyshire Dales,15-19,174,494,-320
E07000035,Derbyshire Dales,20-24,600,556,44
E07000035,Derbyshire Dales,25-29,385,364,21
E07000035,Derbyshire Dales,30-34,300,299,1
E07000035,Derbyshire Dales,35-39,234,189,45
E07000035,Derbyshire Dales,40-44,236,158,78
E07000035,Derbyshire Dales,45-49,219,170,49
E07000035,Derbyshire Dales,50-54,285,174,111
E07000035,Derbyshire Dales,55-59,252,182,70
E07000035,Derbyshire Dales,60-64,199,147,52
E07000035,Derbyshire Dales,65-69,151,132,19
E07000035,Derbyshire Dales,70-74,100,113,-13
E07000035,Derbyshire Dales,75-79,62,65,-3
E07000035,Derbyshire Dales,80-84,71,56,15
E07000035,Derbyshire Dales,85-89,50,40,10
E07000035,Derbyshire Dales,90+,35,36,-1
E08000017,Doncaster,0-4,740,614,126
E08000017,Doncaster,05-Sep,517,452,65
E08000017,Doncaster,41913,415,415,0
E08000017,Doncaster,15-19,437,1154,-717
E08000017,Doncaster,20-24,1925,1424,501
E08000017,Doncaster,25-29,1277,1154,123
E08000017,Doncaster,30-34,1004,902,102
E08000017,Doncaster,35-39,706,653,53
E08000017,Doncaster,40-44,503,455,48
E08000017,Doncaster,45-49,511,479,32
E08000017,Doncaster,50-54,528,443,85
E08000017,Doncaster,55-59,373,352,21
E08000017,Doncaster,60-64,279,269,10
E08000017,Doncaster,65-69,248,185,63
E08000017,Doncaster,70-74,182,156,26
E08000017,Doncaster,75-79,96,63,33
E08000017,Doncaster,80-84,48,79,-31
E08000017,Doncaster,85-89,48,65,-17
E08000017,Doncaster,90+,34,52,-18
E07000108,Dover,0-4,317,221,96
E07000108,Dover,05-Sep,268,166,102
E07000108,Dover,41913,270,169,101
E07000108,Dover,15-19,241,599,-358
E07000108,Dover,20-24,760,619,141
E07000108,Dover,25-29,632,468,164
E07000108,Dover,30-34,509,308,201
E07000108,Dover,35-39,371,241,130
E07000108,Dover,40-44,308,211,97
E07000108,Dover,45-49,332,221,111
E07000108,Dover,50-54,305,213,92
E07000108,Dover,55-59,320,201,119
E07000108,Dover,60-64,282,131,151
E07000108,Dover,65-69,210,173,37
E07000108,Dover,70-74,151,119,32
E07000108,Dover,75-79,101,107,-6
E07000108,Dover,80-84,89,55,34
E07000108,Dover,85-89,48,44,4
E07000108,Dover,90+,38,48,-10
E08000027,Dudley,0-4,867,836,31
E08000027,Dudley,05-Sep,683,557,126
E08000027,Dudley,41913,550,446,104
E08000027,Dudley,15-19,525,1094,-569
E08000027,Dudley,20-24,1917,1548,369
E08000027,Dudley,25-29,1706,1414,292
E08000027,Dudley,30-34,1358,1143,215
E08000027,Dudley,35-39,970,849,121
E08000027,Dudley,40-44,662,610,52
E08000027,Dudley,45-49,649,616,33
E08000027,Dudley,50-54,536,499,37
E08000027,Dudley,55-59,346,413,-67
E08000027,Dudley,60-64,281,326,-45
E08000027,Dudley,65-69,214,260,-46
E08000027,Dudley,70-74,174,207,-33
E08000027,Dudley,75-79,102,129,-27
E08000027,Dudley,80-84,86,117,-31
E08000027,Dudley,85-89,74,133,-59
E08000027,Dudley,90+,64,92,-28
E09000009,Ealing,0-4,1514,2474,-960
E09000009,Ealing,05-Sep,923,1622,-699
E09000009,Ealing,41913,650,1185,-535
E09000009,Ealing,15-19,1215,2043,-828
E09000009,Ealing,20-24,4915,4231,684
E09000009,Ealing,25-29,4295,4621,-326
E09000009,Ealing,30-34,3717,4883,-1166
E09000009,Ealing,35-39,2534,3603,-1069
E09000009,Ealing,40-44,1601,2266,-665
E09000009,Ealing,45-49,1083,1459,-376
E09000009,Ealing,50-54,756,1102,-346
E09000009,Ealing,55-59,539,845,-306
E09000009,Ealing,60-64,365,597,-232
E09000009,Ealing,65-69,212,361,-149
E09000009,Ealing,70-74,135,241,-106
E09000009,Ealing,75-79,96,175,-79
E09000009,Ealing,80-84,93,128,-35
E09000009,Ealing,85-89,70,82,-12
E09000009,Ealing,90+,46,82,-36
E07000009,East Cambridgeshire,0-4,262,273,-11
E07000009,East Cambridgeshire,05-Sep,222,185,37
E07000009,East Cambridgeshire,41913,144,144,0
E07000009,East Cambridgeshire,15-19,193,468,-275
E07000009,East Cambridgeshire,20-24,688,636,52
E07000009,East Cambridgeshire,25-29,711,593,118
E07000009,East Cambridgeshire,30-34,624,474,150
E07000009,East Cambridgeshire,35-39,448,334,114
E07000009,East Cambridgeshire,40-44,287,267,20
E07000009,East Cambridgeshire,45-49,241,228,13
E07000009,East Cambridgeshire,50-54,247,222,25
E07000009,East Cambridgeshire,55-59,220,212,8
E07000009,East Cambridgeshire,60-64,192,152,40
E07000009,East Cambridgeshire,65-69,120,150,-30
E07000009,East Cambridgeshire,70-74,121,73,48
E07000009,East Cambridgeshire,75-79,51,63,-12
E07000009,East Cambridgeshire,80-84,56,72,-16
E07000009,East Cambridgeshire,85-89,54,50,4
E07000009,East Cambridgeshire,90+,48,52,-4
E07000040,East Devon,0-4,494,329,165
E07000040,East Devon,05-Sep,412,251,161
E07000040,East Devon,41913,362,198,164
E07000040,East Devon,15-19,303,683,-380
E07000040,East Devon,20-24,1066,1022,44
E07000040,East Devon,25-29,915,722,193
E07000040,East Devon,30-34,744,456,288
E07000040,East Devon,35-39,577,345,232
E07000040,East Devon,40-44,446,318,128
E07000040,East Devon,45-49,520,264,256
E07000040,East Devon,50-54,588,315,273
E07000040,East Devon,55-59,601,309,292
E07000040,East Devon,60-64,579,270,309
E07000040,East Devon,65-69,527,284,243
E07000040,East Devon,70-74,408,289,119
E07000040,East Devon,75-79,196,153,43
E07000040,East Devon,80-84,151,150,1
E07000040,East Devon,85-89,137,124,13
E07000040,East Devon,90+,77,77,0
E07000049,East Dorset,0-4,368,225,143
E07000049,East Dorset,05-Sep,314,207,107
E07000049,East Dorset,41913,238,172,66
E07000049,East Dorset,15-19,227,473,-246
E07000049,East Dorset,20-24,703,645,58
E07000049,East Dorset,25-29,562,570,-8
E07000049,East Dorset,30-34,539,451,88
E07000049,East Dorset,35-39,461,315,146
E07000049,East Dorset,40-44,339,181,158
E07000049,East Dorset,45-49,326,281,45
E07000049,East Dorset,50-54,327,273,54
E07000049,East Dorset,55-59,361,243,118
E07000049,East Dorset,60-64,318,198,120
E07000049,East Dorset,65-69,266,197,69
E07000049,East Dorset,70-74,228,187,41
E07000049,East Dorset,75-79,115,129,-14
E07000049,East Dorset,80-84,101,124,-23
E07000049,East Dorset,85-89,90,99,-9
E07000049,East Dorset,90+,70,110,-40
E07000085,East Hampshire,0-4,521,280,241
E07000085,East Hampshire,05-Sep,388,229,159
E07000085,East Hampshire,41913,350,244,106
E07000085,East Hampshire,15-19,341,688,-347
E07000085,East Hampshire,20-24,1032,968,64
E07000085,East Hampshire,25-29,920,802,118
E07000085,East Hampshire,30-34,745,578,167
E07000085,East Hampshire,35-39,609,378,231
E07000085,East Hampshire,40-44,496,293,203
E07000085,East Hampshire,45-49,433,357,76
E07000085,East Hampshire,50-54,405,347,58
E07000085,East Hampshire,55-59,302,332,-30
E07000085,East Hampshire,60-64,275,268,7
E07000085,East Hampshire,65-69,214,206,8
E07000085,East Hampshire,70-74,194,156,38
E07000085,East Hampshire,75-79,143,95,48
E07000085,East Hampshire,80-84,105,60,45
E07000085,East Hampshire,85-89,122,81,41
E07000085,East Hampshire,90+,121,66,55
E07000242,East Hertfordshire,0-4,600,468,132
E07000242,East Hertfordshire,05-Sep,361,266,95
E07000242,East Hertfordshire,41913,337,243,94
E07000242,East Hertfordshire,15-19,293,1042,-749
E07000242,East Hertfordshire,20-24,1377,1120,257
E07000242,East Hertfordshire,25-29,1237,1167,70
E07000242,East Hertfordshire,30-34,1087,845,242
E07000242,East Hertfordshire,35-39,826,649,177
E07000242,East Hertfordshire,40-44,522,439,83
E07000242,East Hertfordshire,45-49,455,417,38
E07000242,East Hertfordshire,50-54,401,420,-19
E07000242,East Hertfordshire,55-59,316,388,-72
E07000242,East Hertfordshire,60-64,235,301,-66
E07000242,East Hertfordshire,65-69,192,207,-15
E07000242,East Hertfordshire,70-74,151,174,-23
E07000242,East Hertfordshire,75-79,97,103,-6
E07000242,East Hertfordshire,80-84,74,81,-7
E07000242,East Hertfordshire,85-89,87,106,-19
E07000242,East Hertfordshire,90+,111,64,47
E07000137,East Lindsey,0-4,435,300,135
E07000137,East Lindsey,05-Sep,390,257,133
E07000137,East Lindsey,41913,316,258,58
E07000137,East Lindsey,15-19,325,699,-374
E07000137,East Lindsey,20-24,931,759,172
E07000137,East Lindsey,25-29,661,704,-43
E07000137,East Lindsey,30-34,508,444,64
E07000137,East Lindsey,35-39,423,294,129
E07000137,East Lindsey,40-44,350,263,87
E07000137,East Lindsey,45-49,478,320,158
E07000137,East Lindsey,50-54,628,357,271
E07000137,East Lindsey,55-59,715,336,379
E07000137,East Lindsey,60-64,696,345,351
E07000137,East Lindsey,65-69,622,382,240
E07000137,East Lindsey,70-74,437,357,80
E07000137,East Lindsey,75-79,178,221,-43
E07000137,East Lindsey,80-84,115,143,-28
E07000137,East Lindsey,85-89,74,82,-8
E07000137,East Lindsey,90+,51,60,-9
E07000152,East Northamptonshire,0-4,400,318,82
E07000152,East Northamptonshire,05-Sep,224,192,32
E07000152,East Northamptonshire,41913,347,177,170
E07000152,East Northamptonshire,15-19,232,679,-447
E07000152,East Northamptonshire,20-24,725,619,106
E07000152,East Northamptonshire,25-29,678,599,79
E07000152,East Northamptonshire,30-34,537,403,134
E07000152,East Northamptonshire,35-39,461,338,123
E07000152,East Northamptonshire,40-44,310,270,40
E07000152,East Northamptonshire,45-49,329,245,84
E07000152,East Northamptonshire,50-54,371,311,60
E07000152,East Northamptonshire,55-59,271,200,71
E07000152,East Northamptonshire,60-64,197,170,27
E07000152,East Northamptonshire,65-69,160,131,29
E07000152,East Northamptonshire,70-74,137,106,31
E07000152,East Northamptonshire,75-79,74,67,7
E07000152,East Northamptonshire,80-84,79,41,38
E07000152,East Northamptonshire,85-89,60,43,17
E07000152,East Northamptonshire,90+,69,18,51
E06000011,East Riding of Yorkshire,0-4,879,574,305
E06000011,East Riding of Yorkshire,05-Sep,789,448,341
E06000011,East Riding of Yorkshire,41913,591,326,265
E06000011,East Riding of Yorkshire,15-19,1133,1823,-690
E06000011,East Riding of Yorkshire,20-24,2554,3063,-509
E06000011,East Riding of Yorkshire,25-29,1722,1694,28
E06000011,East Riding of Yorkshire,30-34,1417,1075,342
E06000011,East Riding of Yorkshire,35-39,1158,743,415
E06000011,East Riding of Yorkshire,40-44,807,520,287
E06000011,East Riding of Yorkshire,45-49,877,584,293
E06000011,East Riding of Yorkshire,50-54,844,575,269
E06000011,East Riding of Yorkshire,55-59,873,585,288
E06000011,East Riding of Yorkshire,60-64,817,473,344
E06000011,East Riding of Yorkshire,65-69,683,417,266
E06000011,East Riding of Yorkshire,70-74,488,355,133
E06000011,East Riding of Yorkshire,75-79,250,225,25
E06000011,East Riding of Yorkshire,80-84,199,172,27
E06000011,East Riding of Yorkshire,85-89,172,143,29
E06000011,East Riding of Yorkshire,90+,128,81,47
E07000193,East Staffordshire,0-4,369,289,80
E07000193,East Staffordshire,05-Sep,250,221,29
E07000193,East Staffordshire,41913,207,181,26
E07000193,East Staffordshire,15-19,235,586,-351
E07000193,East Staffordshire,20-24,908,674,234
E07000193,East Staffordshire,25-29,683,703,-20
E07000193,East Staffordshire,30-34,543,500,43
E07000193,East Staffordshire,35-39,437,360,77
E07000193,East Staffordshire,40-44,318,257,61
E07000193,East Staffordshire,45-49,290,255,35
E07000193,East Staffordshire,50-54,326,250,76
E07000193,East Staffordshire,55-59,211,217,-6
E07000193,East Staffordshire,60-64,130,140,-10
E07000193,East Staffordshire,65-69,121,113,8
E07000193,East Staffordshire,70-74,123,96,27
E07000193,East Staffordshire,75-79,64,50,14
E07000193,East Staffordshire,80-84,62,50,12
E07000193,East Staffordshire,85-89,45,47,-2
E07000193,East Staffordshire,90+,40,46,-6
E07000061,Eastbourne,0-4,285,293,-8
E07000061,Eastbourne,05-Sep,242,239,3
E07000061,Eastbourne,41913,229,204,25
E07000061,Eastbourne,15-19,477,487,-10
E07000061,Eastbourne,20-24,930,1140,-210
E07000061,Eastbourne,25-29,625,752,-127
E07000061,Eastbourne,30-34,505,558,-53
E07000061,Eastbourne,35-39,383,380,3
E07000061,Eastbourne,40-44,294,309,-15
E07000061,Eastbourne,45-49,339,264,75
E07000061,Eastbourne,50-54,334,293,41
E07000061,Eastbourne,55-59,327,224,103
E07000061,Eastbourne,60-64,250,214,36
E07000061,Eastbourne,65-69,225,179,46
E07000061,Eastbourne,70-74,196,156,40
E07000061,Eastbourne,75-79,125,91,34
E07000061,Eastbourne,80-84,126,80,46
E07000061,Eastbourne,85-89,100,73,27
E07000061,Eastbourne,90+,83,73,10
E07000086,Eastleigh,0-4,547,386,161
E07000086,Eastleigh,05-Sep,370,298,72
E07000086,Eastleigh,41913,270,201,69
E07000086,Eastleigh,15-19,243,571,-328
E07000086,Eastleigh,20-24,1123,913,210
E07000086,Eastleigh,25-29,1173,895,278
E07000086,Eastleigh,30-34,992,783,209
E07000086,Eastleigh,35-39,765,529,236
E07000086,Eastleigh,40-44,483,391,92
E07000086,Eastleigh,45-49,410,343,67
E07000086,Eastleigh,50-54,309,349,-40
E07000086,Eastleigh,55-59,278,308,-30
E07000086,Eastleigh,60-64,221,210,11
E07000086,Eastleigh,65-69,167,174,-7
E07000086,Eastleigh,70-74,150,142,8
E07000086,Eastleigh,75-79,89,92,-3
E07000086,Eastleigh,80-84,96,78,18
E07000086,Eastleigh,85-89,92,79,13
E07000086,Eastleigh,90+,74,72,2
E07000030,Eden,0-4,132,74,58
E07000030,Eden,05-Sep,82,51,31
E07000030,Eden,41913,96,70,26
E07000030,Eden,15-19,109,249,-140
E07000030,Eden,20-24,330,327,3
E07000030,Eden,25-29,245,281,-36
E07000030,Eden,30-34,181,149,32
E07000030,Eden,35-39,159,105,54
E07000030,Eden,40-44,149,99,50
E07000030,Eden,45-49,158,108,50
E07000030,Eden,50-54,167,130,37
E07000030,Eden,55-59,206,98,108
E07000030,Eden,60-64,144,92,52
E07000030,Eden,65-69,124,88,36
E07000030,Eden,70-74,78,65,13
E07000030,Eden,75-79,31,57,-26
E07000030,Eden,80-84,15,51,-36
E07000030,Eden,85-89,18,24,-6
E07000030,Eden,90+,9,38,-29
E07000207,Elmbridge,0-4,701,516,185
E07000207,Elmbridge,05-Sep,364,380,-16
E07000207,Elmbridge,41913,288,346,-58
E07000207,Elmbridge,15-19,260,1100,-840
E07000207,Elmbridge,20-24,1455,1198,257
E07000207,Elmbridge,25-29,905,1083,-178
E07000207,Elmbridge,30-34,1034,881,153
E07000207,Elmbridge,35-39,1036,779,257
E07000207,Elmbridge,40-44,638,517,121
E07000207,Elmbridge,45-49,433,435,-2
E07000207,Elmbridge,50-54,313,394,-81
E07000207,Elmbridge,55-59,221,344,-123
E07000207,Elmbridge,60-64,168,266,-98
E07000207,Elmbridge,65-69,133,197,-64
E07000207,Elmbridge,70-74,126,136,-10
E07000207,Elmbridge,75-79,82,80,2
E07000207,Elmbridge,80-84,98,87,11
E07000207,Elmbridge,85-89,107,70,37
E07000207,Elmbridge,90+,140,89,51
E09000010,Enfield,0-4,1680,1992,-312
E09000010,Enfield,05-Sep,1089,1424,-335
E09000010,Enfield,41913,833,1056,-223
E09000010,Enfield,15-19,782,1984,-1202
E09000010,Enfield,20-24,3108,2629,479
E09000010,Enfield,25-29,2377,2823,-446
E09000010,Enfield,30-34,2337,2809,-472
E09000010,Enfield,35-39,1857,2255,-398
E09000010,Enfield,40-44,1150,1481,-331
E09000010,Enfield,45-49,892,1112,-220
E09000010,Enfield,50-54,711,975,-264
E09000010,Enfield,55-59,489,758,-269
E09000010,Enfield,60-64,275,550,-275
E09000010,Enfield,65-69,205,341,-136
E09000010,Enfield,70-74,137,243,-106
E09000010,Enfield,75-79,124,155,-31
E09000010,Enfield,80-84,78,103,-25
E09000010,Enfield,85-89,63,79,-16
E09000010,Enfield,90+,63,119,-56
E07000072,Epping Forest,0-4,572,576,-4
E07000072,Epping Forest,05-Sep,410,403,7
E07000072,Epping Forest,41913,294,303,-9
E07000072,Epping Forest,15-19,297,687,-390
E07000072,Epping Forest,20-24,1179,960,219
E07000072,Epping Forest,25-29,1077,1070,7
E07000072,Epping Forest,30-34,1052,934,118
E07000072,Epping Forest,35-39,833,709,124
E07000072,Epping Forest,40-44,493,472,21
E07000072,Epping Forest,45-49,399,394,5
E07000072,Epping Forest,50-54,402,415,-13
E07000072,Epping Forest,55-59,300,357,-57
E07000072,Epping Forest,60-64,183,267,-84
E07000072,Epping Forest,65-69,199,228,-29
E07000072,Epping Forest,70-74,140,185,-45
E07000072,Epping Forest,75-79,114,87,27
E07000072,Epping Forest,80-84,99,87,12
E07000072,Epping Forest,85-89,89,91,-2
E07000072,Epping Forest,90+,89,75,14
E07000208,Epsom and Ewell,0-4,440,319,121
E07000208,Epsom and Ewell,05-Sep,260,210,50
E07000208,Epsom and Ewell,41913,222,149,73
E07000208,Epsom and Ewell,15-19,373,649,-276
E07000208,Epsom and Ewell,20-24,1005,1006,-1
E07000208,Epsom and Ewell,25-29,673,746,-73
E07000208,Epsom and Ewell,30-34,726,606,120
E07000208,Epsom and Ewell,35-39,580,458,122
E07000208,Epsom and Ewell,40-44,394,294,100
E07000208,Epsom and Ewell,45-49,263,282,-19
E07000208,Epsom and Ewell,50-54,190,247,-57
E07000208,Epsom and Ewell,55-59,137,218,-81
E07000208,Epsom and Ewell,60-64,86,170,-84
E07000208,Epsom and Ewell,65-69,93,114,-21
E07000208,Epsom and Ewell,70-74,63,88,-25
E07000208,Epsom and Ewell,75-79,40,55,-15
E07000208,Epsom and Ewell,80-84,37,55,-18
E07000208,Epsom and Ewell,85-89,40,58,-18
E07000208,Epsom and Ewell,90+,36,55,-19
E07000036,Erewash,0-4,353,326,27
E07000036,Erewash,05-Sep,263,227,36
E07000036,Erewash,41913,243,203,40
E07000036,Erewash,15-19,238,443,-205
E07000036,Erewash,20-24,885,702,183
E07000036,Erewash,25-29,834,790,44
E07000036,Erewash,30-34,674,575,99
E07000036,Erewash,35-39,434,400,34
E07000036,Erewash,40-44,296,279,17
E07000036,Erewash,45-49,310,287,23
E07000036,Erewash,50-54,291,281,10
E07000036,Erewash,55-59,207,257,-50
E07000036,Erewash,60-64,153,200,-47
E07000036,Erewash,65-69,123,131,-8
E07000036,Erewash,70-74,90,73,17
E07000036,Erewash,75-79,82,53,29
E07000036,Erewash,80-84,60,61,-1
E07000036,Erewash,85-89,49,49,0
E07000036,Erewash,90+,35,38,-3
E07000041,Exeter,0-4,381,408,-27
E07000041,Exeter,05-Sep,259,325,-66
E07000041,Exeter,41913,209,275,-66
E07000041,Exeter,15-19,3254,585,2669
E07000041,Exeter,20-24,3928,5878,-1950
E07000041,Exeter,25-29,1492,1520,-28
E07000041,Exeter,30-34,977,1000,-23
E07000041,Exeter,35-39,604,756,-152
E07000041,Exeter,40-44,419,458,-39
E07000041,Exeter,45-49,365,402,-37
E07000041,Exeter,50-54,308,359,-51
E07000041,Exeter,55-59,257,274,-17
E07000041,Exeter,60-64,198,186,12
E07000041,Exeter,65-69,166,155,11
E07000041,Exeter,70-74,160,120,40
E07000041,Exeter,75-79,76,78,-2
E07000041,Exeter,80-84,71,53,18
E07000041,Exeter,85-89,46,53,-7
E07000041,Exeter,90+,57,58,-1
E07000087,Fareham,0-4,417,327,90
E07000087,Fareham,05-Sep,341,207,134
E07000087,Fareham,41913,241,197,44
E07000087,Fareham,15-19,238,581,-343
E07000087,Fareham,20-24,907,874,33
E07000087,Fareham,25-29,813,871,-58
E07000087,Fareham,30-34,660,535,125
E07000087,Fareham,35-39,529,373,156
E07000087,Fareham,40-44,347,262,85
E07000087,Fareham,45-49,309,315,-6
E07000087,Fareham,50-54,297,337,-40
E07000087,Fareham,55-59,241,261,-20
E07000087,Fareham,60-64,207,249,-42
E07000087,Fareham,65-69,212,146,66
E07000087,Fareham,70-74,158,140,18
E07000087,Fareham,75-79,111,90,21
E07000087,Fareham,80-84,94,81,13
E07000087,Fareham,85-89,98,66,32
E07000087,Fareham,90+,92,68,24
E07000010,Fenland,0-4,356,373,-17
E07000010,Fenland,05-Sep,277,290,-13
E07000010,Fenland,41913,245,206,39
E07000010,Fenland,15-19,253,469,-216
E07000010,Fenland,20-24,782,612,170
E07000010,Fenland,25-29,668,594,74
E07000010,Fenland,30-34,472,472,0
E07000010,Fenland,35-39,359,299,60
E07000010,Fenland,40-44,321,243,78
E07000010,Fenland,45-49,334,269,65
E07000010,Fenland,50-54,306,251,55
E07000010,Fenland,55-59,275,206,69
E07000010,Fenland,60-64,240,178,62
E07000010,Fenland,65-69,188,177,11
E07000010,Fenland,70-74,175,136,39
E07000010,Fenland,75-79,112,77,35
E07000010,Fenland,80-84,85,75,10
E07000010,Fenland,85-89,51,44,7
E07000010,Fenland,90+,37,49,-12
E07000112,Folkestone and Hythe,0-4,334,224,110
E07000112,Folkestone and Hythe,05-Sep,278,191,87
E07000112,Folkestone and Hythe,41913,181,171,10
E07000112,Folkestone and Hythe,15-19,235,496,-261
E07000112,Folkestone and Hythe,20-24,691,575,116
E07000112,Folkestone and Hythe,25-29,572,502,70
E07000112,Folkestone and Hythe,30-34,447,350,97
E07000112,Folkestone and Hythe,35-39,421,261,160
E07000112,Folkestone and Hythe,40-44,341,198,143
E07000112,Folkestone and Hythe,45-49,346,229,117
E07000112,Folkestone and Hythe,50-54,366,239,127
E07000112,Folkestone and Hythe,55-59,400,239,161
E07000112,Folkestone and Hythe,60-64,291,214,77
E07000112,Folkestone and Hythe,65-69,248,148,100
E07000112,Folkestone and Hythe,70-74,214,148,66
E07000112,Folkestone and Hythe,75-79,129,100,29
E07000112,Folkestone and Hythe,80-84,78,78,0
E07000112,Folkestone and Hythe,85-89,68,62,6
E07000112,Folkestone and Hythe,90+,57,42,15
E07000201,Forest Heath,0-4,235,214,21
E07000201,Forest Heath,05-Sep,148,174,-26
E07000201,Forest Heath,41913,111,106,5
E07000201,Forest Heath,15-19,181,213,-32
E07000201,Forest Heath,20-24,566,353,213
E07000201,Forest Heath,25-29,614,492,122
E07000201,Forest Heath,30-34,505,401,104
E07000201,Forest Heath,35-39,311,283,28
E07000201,Forest Heath,40-44,207,196,11
E07000201,Forest Heath,45-49,211,171,40
E07000201,Forest Heath,50-54,176,176,0
E07000201,Forest Heath,55-59,167,134,33
E07000201,Forest Heath,60-64,116,131,-15
E07000201,Forest Heath,65-69,105,92,13
E07000201,Forest Heath,70-74,81,64,17
E07000201,Forest Heath,75-79,47,36,11
E07000201,Forest Heath,80-84,45,54,-9
E07000201,Forest Heath,85-89,37,39,-2
E07000201,Forest Heath,90+,32,33,-1
E07000080,Forest of Dean,0-4,260,184,76
E07000080,Forest of Dean,05-Sep,231,142,89
E07000080,Forest of Dean,41913,164,122,42
E07000080,Forest of Dean,15-19,631,667,-36
E07000080,Forest of Dean,20-24,645,777,-132
E07000080,Forest of Dean,25-29,448,407,41
E07000080,Forest of Dean,30-34,338,265,73
E07000080,Forest of Dean,35-39,328,205,123
E07000080,Forest of Dean,40-44,251,156,95
E07000080,Forest of Dean,45-49,260,180,80
E07000080,Forest of Dean,50-54,236,199,37
E07000080,Forest of Dean,55-59,231,189,42
E07000080,Forest of Dean,60-64,205,169,36
E07000080,Forest of Dean,65-69,155,141,14
E07000080,Forest of Dean,70-74,125,133,-8
E07000080,Forest of Dean,75-79,72,64,8
E07000080,Forest of Dean,80-84,57,64,-7
E07000080,Forest of Dean,85-89,34,45,-11
E07000080,Forest of Dean,90+,20,35,-15
E07000119,Fylde,0-4,267,193,74
E07000119,Fylde,05-Sep,221,142,79
E07000119,Fylde,41913,232,139,93
E07000119,Fylde,15-19,186,427,-241
E07000119,Fylde,20-24,689,525,164
E07000119,Fylde,25-29,468,427,41
E07000119,Fylde,30-34,429,303,126
E07000119,Fylde,35-39,338,240,98
E07000119,Fylde,40-44,269,182,87
E07000119,Fylde,45-49,317,184,133
E07000119,Fylde,50-54,323,199,124
E07000119,Fylde,55-59,353,182,171
E07000119,Fylde,60-64,319,194,125
E07000119,Fylde,65-69,224,132,92
E07000119,Fylde,70-74,226,149,77
E07000119,Fylde,75-79,137,77,60
E07000119,Fylde,80-84,93,53,40
E07000119,Fylde,85-89,70,44,26
E07000119,Fylde,90+,75,46,29
E08000037,Gateshead,0-4,476,602,-126
E08000037,Gateshead,05-Sep,268,331,-63
E08000037,Gateshead,41913,185,288,-103
E08000037,Gateshead,15-19,1038,771,267
E08000037,Gateshead,20-24,1814,1654,160
E08000037,Gateshead,25-29,1444,1442,2
E08000037,Gateshead,30-34,1035,1082,-47
E08000037,Gateshead,35-39,658,771,-113
E08000037,Gateshead,40-44,397,495,-98
E08000037,Gateshead,45-49,353,435,-82
E08000037,Gateshead,50-54,313,348,-35
E08000037,Gateshead,55-59,228,252,-24
E08000037,Gateshead,60-64,162,193,-31
E08000037,Gateshead,65-69,112,142,-30
E08000037,Gateshead,70-74,79,104,-25
E08000037,Gateshead,75-79,50,46,4
E08000037,Gateshead,80-84,49,47,2
E08000037,Gateshead,85-89,44,33,11
E08000037,Gateshead,90+,33,36,-3
E07000173,Gedling,0-4,441,364,77
E07000173,Gedling,05-Sep,312,284,28
E07000173,Gedling,41913,274,231,43
E07000173,Gedling,15-19,253,580,-327
E07000173,Gedling,20-24,1135,839,296
E07000173,Gedling,25-29,1003,804,199
E07000173,Gedling,30-34,781,651,130
E07000173,Gedling,35-39,636,470,166
E07000173,Gedling,40-44,391,360,31
E07000173,Gedling,45-49,347,342,5
E07000173,Gedling,50-54,305,283,22
E07000173,Gedling,55-59,232,242,-10
E07000173,Gedling,60-64,166,184,-18
E07000173,Gedling,65-69,142,130,12
E07000173,Gedling,70-74,99,92,7
E07000173,Gedling,75-79,53,68,-15
E07000173,Gedling,80-84,85,52,33
E07000173,Gedling,85-89,62,60,2
E07000173,Gedling,90+,67,48,19
E07000081,Gloucester,0-4,359,535,-176
E07000081,Gloucester,05-Sep,271,418,-147
E07000081,Gloucester,41913,231,284,-53
E07000081,Gloucester,15-19,507,575,-68
E07000081,Gloucester,20-24,1323,1309,14
E07000081,Gloucester,25-29,959,987,-28
E07000081,Gloucester,30-34,678,724,-46
E07000081,Gloucester,35-39,525,596,-71
E07000081,Gloucester,40-44,363,353,10
E07000081,Gloucester,45-49,308,378,-70
E07000081,Gloucester,50-54,230,316,-86
E07000081,Gloucester,55-59,213,235,-22
E07000081,Gloucester,60-64,155,198,-43
E07000081,Gloucester,65-69,122,148,-26
E07000081,Gloucester,70-74,97,74,23
E07000081,Gloucester,75-79,92,52,40
E07000081,Gloucester,80-84,52,39,13
E07000081,Gloucester,85-89,53,44,9
E07000081,Gloucester,90+,52,21,31
E07000088,Gosport,0-4,268,327,-59
E07000088,Gosport,05-Sep,189,226,-37
E07000088,Gosport,41913,123,177,-54
E07000088,Gosport,15-19,209,336,-127
E07000088,Gosport,20-24,506,530,-24
E07000088,Gosport,25-29,491,508,-17
E07000088,Gosport,30-34,346,388,-42
E07000088,Gosport,35-39,231,295,-64
E07000088,Gosport,40-44,188,193,-5
E07000088,Gosport,45-49,196,204,-8
E07000088,Gosport,50-54,226,189,37
E07000088,Gosport,55-59,185,184,1
E07000088,Gosport,60-64,140,158,-18
E07000088,Gosport,65-69,99,95,4
E07000088,Gosport,70-74,115,91,24
E07000088,Gosport,75-79,63,48,15
E07000088,Gosport,80-84,50,44,6
E07000088,Gosport,85-89,44,49,-5
E07000088,Gosport,90+,33,50,-17
E07000109,Gravesham,0-4,464,430,34
E07000109,Gravesham,05-Sep,354,330,24
E07000109,Gravesham,41913,257,230,27
E07000109,Gravesham,15-19,241,541,-300
E07000109,Gravesham,20-24,661,666,-5
E07000109,Gravesham,25-29,724,743,-19
E07000109,Gravesham,30-34,653,605,48
E07000109,Gravesham,35-39,474,429,45
E07000109,Gravesham,40-44,315,294,21
E07000109,Gravesham,45-49,278,310,-32
E07000109,Gravesham,50-54,223,268,-45
E07000109,Gravesham,55-59,163,196,-33
E07000109,Gravesham,60-64,120,173,-53
E07000109,Gravesham,65-69,93,120,-27
E07000109,Gravesham,70-74,48,98,-50
E07000109,Gravesham,75-79,41,56,-15
E07000109,Gravesham,80-84,42,51,-9
E07000109,Gravesham,85-89,37,61,-24
E07000109,Gravesham,90+,32,40,-8
E07000145,Great Yarmouth,0-4,240,275,-35
E07000145,Great Yarmouth,05-Sep,185,203,-18
E07000145,Great Yarmouth,41913,191,156,35
E07000145,Great Yarmouth,15-19,209,385,-176
E07000145,Great Yarmouth,20-24,567,600,-33
E07000145,Great Yarmouth,25-29,446,527,-81
E07000145,Great Yarmouth,30-34,335,382,-47
E07000145,Great Yarmouth,35-39,297,299,-2
E07000145,Great Yarmouth,40-44,217,212,5
E07000145,Great Yarmouth,45-49,231,261,-30
E07000145,Great Yarmouth,50-54,293,222,71
E07000145,Great Yarmouth,55-59,270,183,87
E07000145,Great Yarmouth,60-64,265,127,138
E07000145,Great Yarmouth,65-69,209,143,66
E07000145,Great Yarmouth,70-74,139,111,28
E07000145,Great Yarmouth,75-79,67,70,-3
E07000145,Great Yarmouth,80-84,52,44,8
E07000145,Great Yarmouth,85-89,46,45,1
E07000145,Great Yarmouth,90+,21,37,-16
E09000011,Greenwich,0-4,1321,1852,-531
E09000011,Greenwich,05-Sep,747,1226,-479
E09000011,Greenwich,41913,555,855,-300
E09000011,Greenwich,15-19,1175,1409,-234
E09000011,Greenwich,20-24,3856,3485,371
E09000011,Greenwich,25-29,3945,3390,555
E09000011,Greenwich,30-34,3357,3311,46
E09000011,Greenwich,35-39,2299,2488,-189
E09000011,Greenwich,40-44,1304,1542,-238
E09000011,Greenwich,45-49,937,1110,-173
E09000011,Greenwich,50-54,655,870,-215
E09000011,Greenwich,55-59,454,602,-148
E09000011,Greenwich,60-64,271,393,-122
E09000011,Greenwich,65-69,138,243,-105
E09000011,Greenwich,70-74,110,197,-87
E09000011,Greenwich,75-79,63,106,-43
E09000011,Greenwich,80-84,46,101,-55
E09000011,Greenwich,85-89,31,63,-32
E09000011,Greenwich,90+,29,64,-35
E07000209,Guildford,0-4,439,551,-112
E07000209,Guildford,05-Sep,333,346,-13
E07000209,Guildford,41913,239,329,-90
E07000209,Guildford,15-19,2213,1015,1198
E07000209,Guildford,20-24,3088,4125,-1037
E07000209,Guildford,25-29,1279,1756,-477
E07000209,Guildford,30-34,1048,1283,-235
E07000209,Guildford,35-39,744,914,-170
E07000209,Guildford,40-44,546,545,1
E07000209,Guildford,45-49,426,501,-75
E07000209,Guildford,50-54,351,417,-66
E07000209,Guildford,55-59,268,368,-100
E07000209,Guildford,60-64,149,322,-173
E07000209,Guildford,65-69,114,221,-107
E07000209,Guildford,70-74,108,126,-18
E07000209,Guildford,75-79,82,95,-13
E07000209,Guildford,80-84,68,90,-22
E07000209,Guildford,85-89,88,99,-11
E07000209,Guildford,90+,80,97,-17
E09000012,Hackney,0-4,768,1650,-882
E09000012,Hackney,05-Sep,413,886,-473
E09000012,Hackney,41913,350,558,-208
E09000012,Hackney,15-19,542,965,-423
E09000012,Hackney,20-24,4332,2839,1493
E09000012,Hackney,25-29,6521,4441,2080
E09000012,Hackney,30-34,4641,5247,-606
E09000012,Hackney,35-39,2321,3446,-1125
E09000012,Hackney,40-44,986,1636,-650
E09000012,Hackney,45-49,672,994,-322
E09000012,Hackney,50-54,447,666,-219
E09000012,Hackney,55-59,318,463,-145
E09000012,Hackney,60-64,214,316,-102
E09000012,Hackney,65-69,84,163,-79
E09000012,Hackney,70-74,61,86,-25
E09000012,Hackney,75-79,30,89,-59
E09000012,Hackney,80-84,17,79,-62
E09000012,Hackney,85-89,16,43,-27
E09000012,Hackney,90+,13,30,-17
E06000006,Halton,0-4,329,278,51
E06000006,Halton,05-Sep,256,191,65
E06000006,Halton,41913,163,156,7
E06000006,Halton,15-19,213,374,-161
E06000006,Halton,20-24,744,564,180
E06000006,Halton,25-29,574,507,67
E06000006,Halton,30-34,487,415,72
E06000006,Halton,35-39,347,308,39
E06000006,Halton,40-44,276,217,59
E06000006,Halton,45-49,265,207,58
E06000006,Halton,50-54,248,213,35
E06000006,Halton,55-59,173,144,29
E06000006,Halton,60-64,126,132,-6
E06000006,Halton,65-69,83,91,-8
E06000006,Halton,70-74,67,48,19
E06000006,Halton,75-79,35,41,-6
E06000006,Halton,80-84,31,24,7
E06000006,Halton,85-89,15,25,-10
E06000006,Halton,90+,11,21,-10
E07000164,Hambleton,0-4,275,230,45
E07000164,Hambleton,05-Sep,221,168,53
E07000164,Hambleton,41913,185,178,7
E07000164,Hambleton,15-19,167,542,-375
E07000164,Hambleton,20-24,794,653,141
E07000164,Hambleton,25-29,516,505,11
E07000164,Hambleton,30-34,383,365,18
E07000164,Hambleton,35-39,352,233,119
E07000164,Hambleton,40-44,282,196,86
E07000164,Hambleton,45-49,266,203,63
E07000164,Hambleton,50-54,291,240,51
E07000164,Hambleton,55-59,291,187,104
E07000164,Hambleton,60-64,245,180,65
E07000164,Hambleton,65-69,207,137,70
E07000164,Hambleton,70-74,147,132,15
E07000164,Hambleton,75-79,86,97,-11
E07000164,Hambleton,80-84,64,65,-1
E07000164,Hambleton,85-89,54,69,-15
E07000164,Hambleton,90+,47,61,-14
E09000013,Hammersmith and Fulham,0-4,650,1020,-370
E09000013,Hammersmith and Fulham,05-Sep,420,531,-111
E09000013,Hammersmith and Fulham,41913,312,489,-177
E09000013,Hammersmith and Fulham,15-19,593,747,-154
E09000013,Hammersmith and Fulham,20-24,5672,3267,2405
E09000013,Hammersmith and Fulham,25-29,4753,4945,-192
E09000013,Hammersmith and Fulham,30-34,2936,3974,-1038
E09000013,Hammersmith and Fulham,35-39,1626,2398,-772
E09000013,Hammersmith and Fulham,40-44,1008,1240,-232
E09000013,Hammersmith and Fulham,45-49,674,787,-113
E09000013,Hammersmith and Fulham,50-54,490,561,-71
E09000013,Hammersmith and Fulham,55-59,333,403,-70
E09000013,Hammersmith and Fulham,60-64,182,278,-96
E09000013,Hammersmith and Fulham,65-69,127,159,-32
E09000013,Hammersmith and Fulham,70-74,99,133,-34
E09000013,Hammersmith and Fulham,75-79,56,94,-38
E09000013,Hammersmith and Fulham,80-84,54,74,-20
E09000013,Hammersmith and Fulham,85-89,47,68,-21
E09000013,Hammersmith and Fulham,90+,33,46,-13
E07000131,Harborough,0-4,418,230,188
E07000131,Harborough,05-Sep,285,167,118
E07000131,Harborough,41913,240,158,82
E07000131,Harborough,15-19,209,694,-485
E07000131,Harborough,20-24,845,725,120
E07000131,Harborough,25-29,678,582,96
E07000131,Harborough,30-34,639,452,187
E07000131,Harborough,35-39,523,288,235
E07000131,Harborough,40-44,387,233,154
E07000131,Harborough,45-49,350,266,84
E07000131,Harborough,50-54,292,286,6
E07000131,Harborough,55-59,254,254,0
E07000131,Harborough,60-64,221,200,21
E07000131,Harborough,65-69,176,127,49
E07000131,Harborough,70-74,138,91,47
E07000131,Harborough,75-79,91,66,25
E07000131,Harborough,80-84,91,67,24
E07000131,Harborough,85-89,75,66,9
E07000131,Harborough,90+,65,60,5
E09000014,Haringey,0-4,1216,2133,-917
E09000014,Haringey,05-Sep,789,1235,-446
E09000014,Haringey,41913,587,984,-397
E09000014,Haringey,15-19,847,1495,-648
E09000014,Haringey,20-24,4544,3571,973
E09000014,Haringey,25-29,4864,4913,-49
E09000014,Haringey,30-34,3833,4915,-1082
E09000014,Haringey,35-39,2432,3491,-1059
E09000014,Haringey,40-44,1399,2003,-604
E09000014,Haringey,45-49,972,1366,-394
E09000014,Haringey,50-54,728,1017,-289
E09000014,Haringey,55-59,477,729,-252
E09000014,Haringey,60-64,241,421,-180
E09000014,Haringey,65-69,130,314,-184
E09000014,Haringey,70-74,109,170,-61
E09000014,Haringey,75-79,79,135,-56
E09000014,Haringey,80-84,53,115,-62
E09000014,Haringey,85-89,27,85,-58
E09000014,Haringey,90+,32,62,-30
E07000073,Harlow,0-4,469,397,72
E07000073,Harlow,05-Sep,231,264,-33
E07000073,Harlow,41913,171,192,-21
E07000073,Harlow,15-19,159,377,-218
E07000073,Harlow,20-24,632,525,107
E07000073,Harlow,25-29,699,562,137
E07000073,Harlow,30-34,601,511,90
E07000073,Harlow,35-39,409,392,17
E07000073,Harlow,40-44,249,301,-52
E07000073,Harlow,45-49,184,230,-46
E07000073,Harlow,50-54,198,262,-64
E07000073,Harlow,55-59,147,180,-33
E07000073,Harlow,60-64,81,163,-82
E07000073,Harlow,65-69,63,118,-55
E07000073,Harlow,70-74,73,72,1
E07000073,Harlow,75-79,27,40,-13
E07000073,Harlow,80-84,31,45,-14
E07000073,Harlow,85-89,31,53,-22
E07000073,Harlow,90+,13,40,-27
E07000165,Harrogate,0-4,512,339,173
E07000165,Harrogate,05-Sep,372,270,102
E07000165,Harrogate,41913,390,249,141
E07000165,Harrogate,15-19,290,1132,-842
E07000165,Harrogate,20-24,1313,1186,127
E07000165,Harrogate,25-29,881,825,56
E07000165,Harrogate,30-34,731,657,74
E07000165,Harrogate,35-39,593,442,151
E07000165,Harrogate,40-44,463,280,183
E07000165,Harrogate,45-49,371,318,53
E07000165,Harrogate,50-54,394,360,34
E07000165,Harrogate,55-59,385,331,54
E07000165,Harrogate,60-64,258,284,-26
E07000165,Harrogate,65-69,275,198,77
E07000165,Harrogate,70-74,186,157,29
E07000165,Harrogate,75-79,119,116,3
E07000165,Harrogate,80-84,91,81,10
E07000165,Harrogate,85-89,95,56,39
E07000165,Harrogate,90+,80,65,15
E09000015,Harrow,0-4,1304,1613,-309
E09000015,Harrow,05-Sep,753,1098,-345
E09000015,Harrow,41913,700,793,-93
E09000015,Harrow,15-19,667,1827,-1160
E09000015,Harrow,20-24,3006,2471,535
E09000015,Harrow,25-29,2141,2542,-401
E09000015,Harrow,30-34,2194,2717,-523
E09000015,Harrow,35-39,1664,2001,-337
E09000015,Harrow,40-44,1041,1281,-240
E09000015,Harrow,45-49,650,892,-242
E09000015,Harrow,50-54,506,662,-156
E09000015,Harrow,55-59,361,525,-164
E09000015,Harrow,60-64,236,429,-193
E09000015,Harrow,65-69,216,312,-96
E09000015,Harrow,70-74,132,232,-100
E09000015,Harrow,75-79,123,162,-39
E09000015,Harrow,80-84,85,139,-54
E09000015,Harrow,85-89,81,127,-46
E09000015,Harrow,90+,59,132,-73
E07000089,Hart,0-4,587,323,264
E07000089,Hart,05-Sep,360,242,118
E07000089,Hart,41913,197,237,-40
E07000089,Hart,15-19,184,672,-488
E07000089,Hart,20-24,915,692,223
E07000089,Hart,25-29,757,748,9
E07000089,Hart,30-34,883,480,403
E07000089,Hart,35-39,631,394,237
E07000089,Hart,40-44,394,307,87
E07000089,Hart,45-49,297,316,-19
E07000089,Hart,50-54,250,270,-20
E07000089,Hart,55-59,200,276,-76
E07000089,Hart,60-64,146,242,-96
E07000089,Hart,65-69,116,142,-26
E07000089,Hart,70-74,115,113,2
E07000089,Hart,75-79,86,69,17
E07000089,Hart,80-84,61,80,-19
E07000089,Hart,85-89,81,78,3
E07000089,Hart,90+,60,59,1
E06000001,Hartlepool,0-4,179,188,-9
E06000001,Hartlepool,05-Sep,189,134,55
E06000001,Hartlepool,41913,124,147,-23
E06000001,Hartlepool,15-19,153,380,-227
E06000001,Hartlepool,20-24,518,475,43
E06000001,Hartlepool,25-29,338,353,-15
E06000001,Hartlepool,30-34,265,273,-8
E06000001,Hartlepool,35-39,201,174,27
E06000001,Hartlepool,40-44,192,129,63
E06000001,Hartlepool,45-49,148,130,18
E06000001,Hartlepool,50-54,119,119,0
E06000001,Hartlepool,55-59,117,94,23
E06000001,Hartlepool,60-64,82,73,9
E06000001,Hartlepool,65-69,84,55,29
E06000001,Hartlepool,70-74,44,41,3
E06000001,Hartlepool,75-79,31,22,9
E06000001,Hartlepool,80-84,20,16,4
E06000001,Hartlepool,85-89,17,12,5
E06000001,Hartlepool,90+,16,16,0
E07000062,Hastings,0-4,231,313,-82
E07000062,Hastings,05-Sep,192,263,-71
E07000062,Hastings,41913,134,218,-84
E07000062,Hastings,15-19,235,345,-110
E07000062,Hastings,20-24,616,685,-69
E07000062,Hastings,25-29,446,517,-71
E07000062,Hastings,30-34,401,427,-26
E07000062,Hastings,35-39,333,338,-5
E07000062,Hastings,40-44,270,235,35
E07000062,Hastings,45-49,272,268,4
E07000062,Hastings,50-54,321,223,98
E07000062,Hastings,55-59,263,205,58
E07000062,Hastings,60-64,199,169,30
E07000062,Hastings,65-69,195,134,61
E07000062,Hastings,70-74,141,127,14
E07000062,Hastings,75-79,78,80,-2
E07000062,Hastings,80-84,71,71,0
E07000062,Hastings,85-89,75,31,44
E07000062,Hastings,90+,44,34,10
E07000090,Havant,0-4,456,402,54
E07000090,Havant,05-Sep,370,282,88
E07000090,Havant,41913,276,219,57
E07000090,Havant,15-19,267,423,-156
E07000090,Havant,20-24,825,684,141
E07000090,Havant,25-29,791,741,50
E07000090,Havant,30-34,624,569,55
E07000090,Havant,35-39,485,368,117
E07000090,Havant,40-44,384,289,95
E07000090,Havant,45-49,365,283,82
E07000090,Havant,50-54,379,315,64
E07000090,Havant,55-59,332,246,86
E07000090,Havant,60-64,289,231,58
E07000090,Havant,65-69,209,169,40
E07000090,Havant,70-74,184,153,31
E07000090,Havant,75-79,117,104,13
E07000090,Havant,80-84,105,89,16
E07000090,Havant,85-89,75,80,-5
E07000090,Havant,90+,58,101,-43
E09000016,Havering,0-4,1243,1117,126
E09000016,Havering,05-Sep,815,810,5
E09000016,Havering,41913,572,587,-15
E09000016,Havering,15-19,586,1106,-520
E09000016,Havering,20-24,1878,1413,465
E09000016,Havering,25-29,1945,1803,142
E09000016,Havering,30-34,1938,1693,245
E09000016,Havering,35-39,1327,1161,166
E09000016,Havering,40-44,827,806,21
E09000016,Havering,45-49,590,630,-40
E09000016,Havering,50-54,499,577,-78
E09000016,Havering,55-59,434,617,-183
E09000016,Havering,60-64,311,451,-140
E09000016,Havering,65-69,211,358,-147
E09000016,Havering,70-74,157,259,-102
E09000016,Havering,75-79,108,140,-32
E09000016,Havering,80-84,114,106,8
E09000016,Havering,85-89,84,116,-32
E09000016,Havering,90+,96,82,14
E06000019,"Herefordshire, County of",0-4,456,322,134
E06000019,"Herefordshire, County of",05-Sep,363,248,115
E06000019,"Herefordshire, County of",41913,274,255,19
E06000019,"Herefordshire, County of",15-19,303,775,-472
E06000019,"Herefordshire, County of",20-24,1196,1103,93
E06000019,"Herefordshire, County of",25-29,740,825,-85
E06000019,"Herefordshire, County of",30-34,581,526,55
E06000019,"Herefordshire, County of",35-39,490,407,83
E06000019,"Herefordshire, County of",40-44,355,314,41
E06000019,"Herefordshire, County of",45-49,408,293,115
E06000019,"Herefordshire, County of",50-54,447,338,109
E06000019,"Herefordshire, County of",55-59,518,297,221
E06000019,"Herefordshire, County of",60-64,444,273,171
E06000019,"Herefordshire, County of",65-69,419,256,163
E06000019,"Herefordshire, County of",70-74,258,286,-28
E06000019,"Herefordshire, County of",75-79,138,176,-38
E06000019,"Herefordshire, County of",80-84,93,79,14
E06000019,"Herefordshire, County of",85-89,79,67,12
E06000019,"Herefordshire, County of",90+,77,64,13
E07000098,Hertsmere,0-4,537,480,57
E07000098,Hertsmere,05-Sep,356,364,-8
E07000098,Hertsmere,41913,311,260,51
E07000098,Hertsmere,15-19,282,766,-484
E07000098,Hertsmere,20-24,1351,965,386
E07000098,Hertsmere,25-29,848,916,-68
E07000098,Hertsmere,30-34,883,877,6
E07000098,Hertsmere,35-39,672,674,-2
E07000098,Hertsmere,40-44,475,412,63
E07000098,Hertsmere,45-49,328,367,-39
E07000098,Hertsmere,50-54,268,344,-76
E07000098,Hertsmere,55-59,225,273,-48
E07000098,Hertsmere,60-64,146,206,-60
E07000098,Hertsmere,65-69,134,143,-9
E07000098,Hertsmere,70-74,115,135,-20
E07000098,Hertsmere,75-79,91,87,4
E07000098,Hertsmere,80-84,87,66,21
E07000098,Hertsmere,85-89,74,83,-9
E07000098,Hertsmere,90+,92,73,19
E07000037,High Peak,0-4,256,145,111
E07000037,High Peak,05-Sep,166,111,55
E07000037,High Peak,41913,119,131,-12
E07000037,High Peak,15-19,200,473,-273
E07000037,High Peak,20-24,771,803,-32
E07000037,High Peak,25-29,520,542,-22
E07000037,High Peak,30-34,476,292,184
E07000037,High Peak,35-39,340,220,120
E07000037,High Peak,40-44,200,185,15
E07000037,High Peak,45-49,215,205,10
E07000037,High Peak,50-54,227,199,28
E07000037,High Peak,55-59,226,178,48
E07000037,High Peak,60-64,183,140,43
E07000037,High Peak,65-69,115,128,-13
E07000037,High Peak,70-74,78,96,-18
E07000037,High Peak,75-79,46,55,-9
E07000037,High Peak,80-84,48,50,-2
E07000037,High Peak,85-89,35,40,-5
E07000037,High Peak,90+,30,16,14
E09000017,Hillingdon,0-4,1584,1791,-207
E09000017,Hillingdon,05-Sep,946,1378,-432
E09000017,Hillingdon,41913,715,914,-199
E09000017,Hillingdon,15-19,1679,1579,100
E09000017,Hillingdon,20-24,3797,4085,-288
E09000017,Hillingdon,25-29,2412,2972,-560
E09000017,Hillingdon,30-34,2562,2733,-171
E09000017,Hillingdon,35-39,2012,2160,-148
E09000017,Hillingdon,40-44,1244,1494,-250
E09000017,Hillingdon,45-49,782,1002,-220
E09000017,Hillingdon,50-54,625,754,-129
E09000017,Hillingdon,55-59,486,685,-199
E09000017,Hillingdon,60-64,393,528,-135
E09000017,Hillingdon,65-69,234,388,-154
E09000017,Hillingdon,70-74,153,252,-99
E09000017,Hillingdon,75-79,119,166,-47
E09000017,Hillingdon,80-84,87,93,-6
E09000017,Hillingdon,85-89,99,120,-21
E09000017,Hillingdon,90+,76,102,-26
E07000132,Hinckley and Bosworth,0-4,423,302,121
E07000132,Hinckley and Bosworth,05-Sep,286,208,78
E07000132,Hinckley and Bosworth,41913,223,187,36
E07000132,Hinckley and Bosworth,15-19,210,528,-318
E07000132,Hinckley and Bosworth,20-24,956,653,303
E07000132,Hinckley and Bosworth,25-29,877,702,175
E07000132,Hinckley and Bosworth,30-34,700,464,236
E07000132,Hinckley and Bosworth,35-39,495,334,161
E07000132,Hinckley and Bosworth,40-44,350,239,111
E07000132,Hinckley and Bosworth,45-49,337,282,55
E07000132,Hinckley and Bosworth,50-54,322,258,64
E07000132,Hinckley and Bosworth,55-59,247,219,28
E07000132,Hinckley and Bosworth,60-64,206,171,35
E07000132,Hinckley and Bosworth,65-69,160,162,-2
E07000132,Hinckley and Bosworth,70-74,98,114,-16
E07000132,Hinckley and Bosworth,75-79,87,83,4
E07000132,Hinckley and Bosworth,80-84,67,68,-1
E07000132,Hinckley and Bosworth,85-89,54,48,6
E07000132,Hinckley and Bosworth,90+,31,34,-3
E07000227,Horsham,0-4,589,231,358
E07000227,Horsham,05-Sep,339,233,106
E07000227,Horsham,41913,417,286,131
E07000227,Horsham,15-19,339,966,-627
E07000227,Horsham,20-24,1319,942,377
E07000227,Horsham,25-29,1006,782,224
E07000227,Horsham,30-34,943,598,345
E07000227,Horsham,35-39,745,413,332
E07000227,Horsham,40-44,552,318,234
E07000227,Horsham,45-49,442,380,62
E07000227,Horsham,50-54,434,389,45
E07000227,Horsham,55-59,358,343,15
E07000227,Horsham,60-64,282,281,1
E07000227,Horsham,65-69,276,211,65
E07000227,Horsham,70-74,235,189,46
E07000227,Horsham,75-79,149,97,52
E07000227,Horsham,80-84,94,81,13
E07000227,Horsham,85-89,94,89,5
E07000227,Horsham,90+,90,95,-5
E09000018,Hounslow,0-4,1286,1861,-575
E09000018,Hounslow,05-Sep,821,1108,-287
E09000018,Hounslow,41913,481,801,-320
E09000018,Hounslow,15-19,758,1313,-555
E09000018,Hounslow,20-24,2952,2775,177
E09000018,Hounslow,25-29,2725,3043,-318
E09000018,Hounslow,30-34,2658,3324,-666
E09000018,Hounslow,35-39,2065,2685,-620
E09000018,Hounslow,40-44,1311,1678,-367
E09000018,Hounslow,45-49,858,1055,-197
E09000018,Hounslow,50-54,635,789,-154
E09000018,Hounslow,55-59,401,631,-230
E09000018,Hounslow,60-64,261,473,-212
E09000018,Hounslow,65-69,206,296,-90
E09000018,Hounslow,70-74,109,178,-69
E09000018,Hounslow,75-79,83,126,-43
E09000018,Hounslow,80-84,54,109,-55
E09000018,Hounslow,85-89,47,84,-37
E09000018,Hounslow,90+,32,73,-41
E07000011,Huntingdonshire,0-4,608,528,80
E07000011,Huntingdonshire,05-Sep,377,392,-15
E07000011,Huntingdonshire,41913,224,311,-87
E07000011,Huntingdonshire,15-19,303,955,-652
E07000011,Huntingdonshire,20-24,1527,1112,415
E07000011,Huntingdonshire,25-29,1387,1162,225
E07000011,Huntingdonshire,30-34,1080,901,179
E07000011,Huntingdonshire,35-39,731,652,79
E07000011,Huntingdonshire,40-44,504,447,57
E07000011,Huntingdonshire,45-49,470,445,25
E07000011,Huntingdonshire,50-54,426,470,-44
E07000011,Huntingdonshire,55-59,359,402,-43
E07000011,Huntingdonshire,60-64,302,341,-39
E07000011,Huntingdonshire,65-69,228,218,10
E07000011,Huntingdonshire,70-74,164,214,-50
E07000011,Huntingdonshire,75-79,104,109,-5
E07000011,Huntingdonshire,80-84,107,83,24
E07000011,Huntingdonshire,85-89,76,42,34
E07000011,Huntingdonshire,90+,78,53,25
E07000120,Hyndburn,0-4,271,274,-3
E07000120,Hyndburn,05-Sep,199,194,5
E07000120,Hyndburn,41913,160,139,21
E07000120,Hyndburn,15-19,172,328,-156
E07000120,Hyndburn,20-24,609,461,148
E07000120,Hyndburn,25-29,505,431,74
E07000120,Hyndburn,30-34,368,331,37
E07000120,Hyndburn,35-39,232,259,-27
E07000120,Hyndburn,40-44,171,192,-21
E07000120,Hyndburn,45-49,185,207,-22
E07000120,Hyndburn,50-54,191,196,-5
E07000120,Hyndburn,55-59,152,127,25
E07000120,Hyndburn,60-64,105,114,-9
E07000120,Hyndburn,65-69,75,87,-12
E07000120,Hyndburn,70-74,91,55,36
E07000120,Hyndburn,75-79,44,38,6
E07000120,Hyndburn,80-84,46,19,27
E07000120,Hyndburn,85-89,22,27,-5
E07000120,Hyndburn,90+,22,17,5
E07000202,Ipswich,0-4,382,600,-218
E07000202,Ipswich,05-Sep,348,490,-142
E07000202,Ipswich,41913,211,324,-113
E07000202,Ipswich,15-19,431,587,-156
E07000202,Ipswich,20-24,1115,1165,-50
E07000202,Ipswich,25-29,1008,1121,-113
E07000202,Ipswich,30-34,766,1029,-263
E07000202,Ipswich,35-39,517,673,-156
E07000202,Ipswich,40-44,325,513,-188
E07000202,Ipswich,45-49,313,387,-74
E07000202,Ipswich,50-54,212,345,-133
E07000202,Ipswich,55-59,218,295,-77
E07000202,Ipswich,60-64,145,204,-59
E07000202,Ipswich,65-69,118,161,-43
E07000202,Ipswich,70-74,71,106,-35
E07000202,Ipswich,75-79,54,60,-6
E07000202,Ipswich,80-84,50,51,-1
E07000202,Ipswich,85-89,49,72,-23
E07000202,Ipswich,90+,50,82,-32
E06000046,Isle of Wight,0-4,221,157,64
E06000046,Isle of Wight,05-Sep,223,163,60
E06000046,Isle of Wight,41913,166,120,46
E06000046,Isle of Wight,15-19,158,515,-357
E06000046,Isle of Wight,20-24,714,710,4
E06000046,Isle of Wight,25-29,407,480,-73
E06000046,Isle of Wight,30-34,326,353,-27
E06000046,Isle of Wight,35-39,275,241,34
E06000046,Isle of Wight,40-44,258,179,79
E06000046,Isle of Wight,45-49,335,192,143
E06000046,Isle of Wight,50-54,345,226,119
E06000046,Isle of Wight,55-59,441,166,275
E06000046,Isle of Wight,60-64,449,175,274
E06000046,Isle of Wight,65-69,352,134,218
E06000046,Isle of Wight,70-74,265,146,119
E06000046,Isle of Wight,75-79,102,74,28
E06000046,Isle of Wight,80-84,66,59,7
E06000046,Isle of Wight,85-89,44,47,-3
E06000046,Isle of Wight,90+,32,37,-5
E06000053,Isles of Scilly,0-4,2,3,-1
E06000053,Isles of Scilly,05-Sep,10,3,7
E06000053,Isles of Scilly,41913,3,10,-7
E06000053,Isles of Scilly,15-19,12,12,0
E06000053,Isles of Scilly,20-24,40,41,-1
E06000053,Isles of Scilly,25-29,41,42,-1
E06000053,Isles of Scilly,30-34,29,16,13
E06000053,Isles of Scilly,35-39,8,21,-13
E06000053,Isles of Scilly,40-44,7,15,-8
E06000053,Isles of Scilly,45-49,20,15,5
E06000053,Isles of Scilly,50-54,25,18,7
E06000053,Isles of Scilly,55-59,12,13,-1
E06000053,Isles of Scilly,60-64,3,12,-9
E06000053,Isles of Scilly,65-69,3,9,-6
E06000053,Isles of Scilly,70-74,0,0,0
E06000053,Isles of Scilly,75-79,0,0,0
E06000053,Isles of Scilly,80-84,0,0,0
E06000053,Isles of Scilly,85-89,0,3,-3
E06000053,Isles of Scilly,90+,0,0,0
E09000019,Islington,0-4,548,1260,-712
E09000019,Islington,05-Sep,269,535,-266
E09000019,Islington,41913,188,364,-176
E09000019,Islington,15-19,1219,728,491
E09000019,Islington,20-24,6519,5027,1492
E09000019,Islington,25-29,5907,5393,514
E09000019,Islington,30-34,3943,5445,-1502
E09000019,Islington,35-39,1854,3189,-1335
E09000019,Islington,40-44,887,1426,-539
E09000019,Islington,45-49,568,864,-296
E09000019,Islington,50-54,389,634,-245
E09000019,Islington,55-59,303,418,-115
E09000019,Islington,60-64,150,290,-140
E09000019,Islington,65-69,102,203,-101
E09000019,Islington,70-74,68,137,-69
E09000019,Islington,75-79,51,82,-31
E09000019,Islington,80-84,24,70,-46
E09000019,Islington,85-89,11,43,-32
E09000019,Islington,90+,20,47,-27
E09000020,Kensington and Chelsea,0-4,382,741,-359
E09000020,Kensington and Chelsea,05-Sep,246,435,-189
E09000020,Kensington and Chelsea,41913,198,481,-283
E09000020,Kensington and Chelsea,15-19,494,552,-58
E09000020,Kensington and Chelsea,20-24,3013,1840,1173
E09000020,Kensington and Chelsea,25-29,2132,2008,124
E09000020,Kensington and Chelsea,30-34,1573,2116,-543
E09000020,Kensington and Chelsea,35-39,960,1517,-557
E09000020,Kensington and Chelsea,40-44,630,956,-326
E09000020,Kensington and Chelsea,45-49,447,645,-198
E09000020,Kensington and Chelsea,50-54,382,525,-143
E09000020,Kensington and Chelsea,55-59,286,416,-130
E09000020,Kensington and Chelsea,60-64,163,260,-97
E09000020,Kensington and Chelsea,65-69,134,217,-83
E09000020,Kensington and Chelsea,70-74,102,150,-48
E09000020,Kensington and Chelsea,75-79,63,102,-39
E09000020,Kensington and Chelsea,80-84,51,67,-16
E09000020,Kensington and Chelsea,85-89,44,65,-21
E09000020,Kensington and Chelsea,90+,33,66,-33
E07000153,Kettering,0-4,409,267,142
E07000153,Kettering,05-Sep,269,258,11
E07000153,Kettering,41913,206,176,30
E07000153,Kettering,15-19,233,471,-238
E07000153,Kettering,20-24,838,575,263
E07000153,Kettering,25-29,717,588,129
E07000153,Kettering,30-34,584,464,120
E07000153,Kettering,35-39,447,376,71
E07000153,Kettering,40-44,342,282,60
E07000153,Kettering,45-49,314,279,35
E07000153,Kettering,50-54,317,255,62
E07000153,Kettering,55-59,229,186,43
E07000153,Kettering,60-64,149,158,-9
E07000153,Kettering,65-69,103,153,-50
E07000153,Kettering,70-74,113,106,7
E07000153,Kettering,75-79,54,76,-22
E07000153,Kettering,80-84,55,60,-5
E07000153,Kettering,85-89,29,42,-13
E07000153,Kettering,90+,14,50,-36
E07000146,King's Lynn and West Norfolk,0-4,393,307,86
E07000146,King's Lynn and West Norfolk,05-Sep,295,254,41
E07000146,King's Lynn and West Norfolk,41913,229,211,18
E07000146,King's Lynn and West Norfolk,15-19,264,674,-410
E07000146,King's Lynn and West Norfolk,20-24,834,864,-30
E07000146,King's Lynn and West Norfolk,25-29,722,739,-17
E07000146,King's Lynn and West Norfolk,30-34,571,513,58
E07000146,King's Lynn and West Norfolk,35-39,411,303,108
E07000146,King's Lynn and West Norfolk,40-44,332,300,32
E07000146,King's Lynn and West Norfolk,45-49,394,317,77
E07000146,King's Lynn and West Norfolk,50-54,413,340,73
E07000146,King's Lynn and West Norfolk,55-59,434,303,131
E07000146,King's Lynn and West Norfolk,60-64,430,283,147
E07000146,King's Lynn and West Norfolk,65-69,355,212,143
E07000146,King's Lynn and West Norfolk,70-74,214,194,20
E07000146,King's Lynn and West Norfolk,75-79,108,157,-49
E07000146,King's Lynn and West Norfolk,80-84,85,103,-18
E07000146,King's Lynn and West Norfolk,85-89,51,83,-32
E07000146,King's Lynn and West Norfolk,90+,65,62,3
E06000010,"Kingston upon Hull, City of",0-4,513,665,-152
E06000010,"Kingston upon Hull, City of",05-Sep,363,519,-156
E06000010,"Kingston upon Hull, City of",41913,225,385,-160
E06000010,"Kingston upon Hull, City of",15-19,1236,614,622
E06000010,"Kingston upon Hull, City of",20-24,3132,3413,-281
E06000010,"Kingston upon Hull, City of",25-29,1458,1755,-297
E06000010,"Kingston upon Hull, City of",30-34,902,1150,-248
E06000010,"Kingston upon Hull, City of",35-39,586,841,-255
E06000010,"Kingston upon Hull, City of",40-44,408,620,-212
E06000010,"Kingston upon Hull, City of",45-49,358,563,-205
E06000010,"Kingston upon Hull, City of",50-54,319,392,-73
E06000010,"Kingston upon Hull, City of",55-59,268,388,-120
E06000010,"Kingston upon Hull, City of",60-64,189,241,-52
E06000010,"Kingston upon Hull, City of",65-69,145,191,-46
E06000010,"Kingston upon Hull, City of",70-74,103,138,-35
E06000010,"Kingston upon Hull, City of",75-79,69,63,6
E06000010,"Kingston upon Hull, City of",80-84,58,74,-16
E06000010,"Kingston upon Hull, City of",85-89,39,62,-23
E06000010,"Kingston upon Hull, City of",90+,38,51,-13
E09000021,Kingston upon Thames,0-4,759,928,-169
E09000021,Kingston upon Thames,05-Sep,407,499,-92
E09000021,Kingston upon Thames,41913,328,417,-89
E09000021,Kingston upon Thames,15-19,885,973,-88
E09000021,Kingston upon Thames,20-24,3143,3516,-373
E09000021,Kingston upon Thames,25-29,1979,2289,-310
E09000021,Kingston upon Thames,30-34,1838,1946,-108
E09000021,Kingston upon Thames,35-39,1330,1403,-73
E09000021,Kingston upon Thames,40-44,795,972,-177
E09000021,Kingston upon Thames,45-49,601,634,-33
E09000021,Kingston upon Thames,50-54,383,508,-125
E09000021,Kingston upon Thames,55-59,263,368,-105
E09000021,Kingston upon Thames,60-64,171,280,-109
E09000021,Kingston upon Thames,65-69,130,213,-83
E09000021,Kingston upon Thames,70-74,97,147,-50
E09000021,Kingston upon Thames,75-79,70,95,-25
E09000021,Kingston upon Thames,80-84,57,71,-14
E09000021,Kingston upon Thames,85-89,55,67,-12
E09000021,Kingston upon Thames,90+,83,70,13
E08000034,Kirklees,0-4,920,896,24
E08000034,Kirklees,05-Sep,654,670,-16
E08000034,Kirklees,41913,441,488,-47
E08000034,Kirklees,15-19,1387,1650,-263
E08000034,Kirklees,20-24,3451,4112,-661
E08000034,Kirklees,25-29,2038,2344,-306
E08000034,Kirklees,30-34,1577,1610,-33
E08000034,Kirklees,35-39,1131,1063,68
E08000034,Kirklees,40-44,806,742,64
E08000034,Kirklees,45-49,730,704,26
E08000034,Kirklees,50-54,581,632,-51
E08000034,Kirklees,55-59,499,532,-33
E08000034,Kirklees,60-64,347,376,-29
E08000034,Kirklees,65-69,261,325,-64
E08000034,Kirklees,70-74,194,260,-66
E08000034,Kirklees,75-79,124,117,7
E08000034,Kirklees,80-84,75,111,-36
E08000034,Kirklees,85-89,84,76,8
E08000034,Kirklees,90+,77,62,15
E08000011,Knowsley,0-4,678,549,129
E08000011,Knowsley,05-Sep,479,391,88
E08000011,Knowsley,41913,317,333,-16
E08000011,Knowsley,15-19,313,437,-124
E08000011,Knowsley,20-24,963,762,201
E08000011,Knowsley,25-29,1077,881,196
E08000011,Knowsley,30-34,923,779,144
E08000011,Knowsley,35-39,637,576,61
E08000011,Knowsley,40-44,365,392,-27
E08000011,Knowsley,45-49,351,340,11
E08000011,Knowsley,50-54,331,359,-28
E08000011,Knowsley,55-59,237,238,-1
E08000011,Knowsley,60-64,173,126,47
E08000011,Knowsley,65-69,129,120,9
E08000011,Knowsley,70-74,62,99,-37
E08000011,Knowsley,75-79,35,59,-24
E08000011,Knowsley,80-84,20,49,-29
E08000011,Knowsley,85-89,34,54,-20
E08000011,Knowsley,90+,27,45,-18
E09000022,Lambeth,0-4,1011,2075,-1064
E09000022,Lambeth,05-Sep,621,1060,-439
E09000022,Lambeth,41913,453,772,-319
E09000022,Lambeth,15-19,972,1529,-557
E09000022,Lambeth,20-24,9356,4859,4497
E09000022,Lambeth,25-29,10980,9117,1863
E09000022,Lambeth,30-34,5502,7749,-2247
E09000022,Lambeth,35-39,2845,4556,-1711
E09000022,Lambeth,40-44,1489,2259,-770
E09000022,Lambeth,45-49,1010,1463,-453
E09000022,Lambeth,50-54,754,1143,-389
E09000022,Lambeth,55-59,503,738,-235
E09000022,Lambeth,60-64,288,452,-164
E09000022,Lambeth,65-69,149,271,-122
E09000022,Lambeth,70-74,110,191,-81
E09000022,Lambeth,75-79,85,112,-27
E09000022,Lambeth,80-84,65,94,-29
E09000022,Lambeth,85-89,40,56,-16
E09000022,Lambeth,90+,36,31,5
E07000121,Lancaster,0-4,256,203,53
E07000121,Lancaster,05-Sep,220,165,55
E07000121,Lancaster,41913,225,215,10
E07000121,Lancaster,15-19,2505,723,1782
E07000121,Lancaster,20-24,2270,3933,-1663
E07000121,Lancaster,25-29,813,1018,-205
E07000121,Lancaster,30-34,511,578,-67
E07000121,Lancaster,35-39,397,383,14
E07000121,Lancaster,40-44,268,271,-3
E07000121,Lancaster,45-49,327,244,83
E07000121,Lancaster,50-54,292,241,51
E07000121,Lancaster,55-59,286,217,69
E07000121,Lancaster,60-64,253,169,84
E07000121,Lancaster,65-69,222,142,80
E07000121,Lancaster,70-74,159,130,29
E07000121,Lancaster,75-79,72,96,-24
E07000121,Lancaster,80-84,59,64,-5
E07000121,Lancaster,85-89,49,41,8
E07000121,Lancaster,90+,41,32,9
E08000035,Leeds,0-4,1496,1896,-400
E08000035,Leeds,05-Sep,987,1311,-324
E08000035,Leeds,41913,733,924,-191
E08000035,Leeds,15-19,8914,2926,5988
E08000035,Leeds,20-24,13842,16589,-2747
E08000035,Leeds,25-29,6035,7224,-1189
E08000035,Leeds,30-34,3588,4369,-781
E08000035,Leeds,35-39,2318,2918,-600
E08000035,Leeds,40-44,1302,1892,-590
E08000035,Leeds,45-49,1085,1437,-352
E08000035,Leeds,50-54,887,1198,-311
E08000035,Leeds,55-59,651,1019,-368
E08000035,Leeds,60-64,459,728,-269
E08000035,Leeds,65-69,372,571,-199
E08000035,Leeds,70-74,337,371,-34
E08000035,Leeds,75-79,190,221,-31
E08000035,Leeds,80-84,165,170,-5
E08000035,Leeds,85-89,114,175,-61
E08000035,Leeds,90+,85,139,-54
E06000016,Leicester,0-4,931,1348,-417
E06000016,Leicester,05-Sep,661,1053,-392
E06000016,Leicester,41913,455,792,-337
E06000016,Leicester,15-19,4396,1418,2978
E06000016,Leicester,20-24,7475,8545,-1070
E06000016,Leicester,25-29,2144,3432,-1288
E06000016,Leicester,30-34,1569,2511,-942
E06000016,Leicester,35-39,1082,1760,-678
E06000016,Leicester,40-44,668,1135,-467
E06000016,Leicester,45-49,561,810,-249
E06000016,Leicester,50-54,414,646,-232
E06000016,Leicester,55-59,359,465,-106
E06000016,Leicester,60-64,213,391,-178
E06000016,Leicester,65-69,148,272,-124
E06000016,Leicester,70-74,78,143,-65
E06000016,Leicester,75-79,100,112,-12
E06000016,Leicester,80-84,95,97,-2
E06000016,Leicester,85-89,92,111,-19
E06000016,Leicester,90+,101,86,15
E07000063,Lewes,0-4,408,261,147
E07000063,Lewes,05-Sep,271,203,68
E07000063,Lewes,41913,210,176,34
E07000063,Lewes,15-19,229,406,-177
E07000063,Lewes,20-24,781,867,-86
E07000063,Lewes,25-29,631,675,-44
E07000063,Lewes,30-34,579,500,79
E07000063,Lewes,35-39,463,329,134
E07000063,Lewes,40-44,391,276,115
E07000063,Lewes,45-49,323,273,50
E07000063,Lewes,50-54,333,305,28
E07000063,Lewes,55-59,247,208,39
E07000063,Lewes,60-64,228,167,61
E07000063,Lewes,65-69,216,133,83
E07000063,Lewes,70-74,153,129,24
E07000063,Lewes,75-79,115,66,49
E07000063,Lewes,80-84,101,87,14
E07000063,Lewes,85-89,85,93,-8
E07000063,Lewes,90+,82,70,12
E09000023,Lewisham,0-4,1231,2247,-1016
E09000023,Lewisham,05-Sep,674,1310,-636
E09000023,Lewisham,41913,524,919,-395
E09000023,Lewisham,15-19,1017,1485,-468
E09000023,Lewisham,20-24,5042,3668,1374
E09000023,Lewisham,25-29,5189,4405,784
E09000023,Lewisham,30-34,4418,4372,46
E09000023,Lewisham,35-39,2651,3392,-741
E09000023,Lewisham,40-44,1397,1874,-477
E09000023,Lewisham,45-49,985,1250,-265
E09000023,Lewisham,50-54,763,929,-166
E09000023,Lewisham,55-59,452,735,-283
E09000023,Lewisham,60-64,267,429,-162
E09000023,Lewisham,65-69,138,273,-135
E09000023,Lewisham,70-74,106,186,-80
E09000023,Lewisham,75-79,79,105,-26
E09000023,Lewisham,80-84,45,111,-66
E09000023,Lewisham,85-89,54,70,-16
E09000023,Lewisham,90+,32,52,-20
E07000194,Lichfield,0-4,466,304,162
E07000194,Lichfield,05-Sep,284,236,48
E07000194,Lichfield,41913,187,185,2
E07000194,Lichfield,15-19,211,510,-299
E07000194,Lichfield,20-24,973,647,326
E07000194,Lichfield,25-29,742,660,82
E07000194,Lichfield,30-34,612,494,118
E07000194,Lichfield,35-39,457,359,98
E07000194,Lichfield,40-44,283,249,34
E07000194,Lichfield,45-49,298,290,8
E07000194,Lichfield,50-54,302,263,39
E07000194,Lichfield,55-59,217,235,-18
E07000194,Lichfield,60-64,192,185,7
E07000194,Lichfield,65-69,146,160,-14
E07000194,Lichfield,70-74,155,129,26
E07000194,Lichfield,75-79,105,104,1
E07000194,Lichfield,80-84,70,83,-13
E07000194,Lichfield,85-89,93,63,30
E07000194,Lichfield,90+,68,62,6
E07000138,Lincoln,0-4,297,483,-186
E07000138,Lincoln,05-Sep,220,323,-103
E07000138,Lincoln,41913,189,235,-46
E07000138,Lincoln,15-19,3437,485,2952
E07000138,Lincoln,20-24,2612,4067,-1455
E07000138,Lincoln,25-29,1036,1355,-319
E07000138,Lincoln,30-34,602,824,-222
E07000138,Lincoln,35-39,379,515,-136
E07000138,Lincoln,40-44,320,338,-18
E07000138,Lincoln,45-49,279,340,-61
E07000138,Lincoln,50-54,233,258,-25
E07000138,Lincoln,55-59,215,220,-5
E07000138,Lincoln,60-64,121,160,-39
E07000138,Lincoln,65-69,99,121,-22
E07000138,Lincoln,70-74,92,82,10
E07000138,Lincoln,75-79,69,68,1
E07000138,Lincoln,80-84,73,56,17
E07000138,Lincoln,85-89,63,50,13
E07000138,Lincoln,90+,61,34,27
E08000012,Liverpool,0-4,1201,1381,-180
E08000012,Liverpool,05-Sep,743,894,-151
E08000012,Liverpool,41913,576,656,-80
E08000012,Liverpool,15-19,6771,1331,5440
E08000012,Liverpool,20-24,8097,11027,-2930
E08000012,Liverpool,25-29,3804,4452,-648
E08000012,Liverpool,30-34,2445,2814,-369
E08000012,Liverpool,35-39,1620,2036,-416
E08000012,Liverpool,40-44,1023,1163,-140
E08000012,Liverpool,45-49,897,986,-89
E08000012,Liverpool,50-54,671,843,-172
E08000012,Liverpool,55-59,539,573,-34
E08000012,Liverpool,60-64,317,382,-65
E08000012,Liverpool,65-69,242,298,-56
E08000012,Liverpool,70-74,176,187,-11
E08000012,Liverpool,75-79,119,99,20
E08000012,Liverpool,80-84,79,86,-7
E08000012,Liverpool,85-89,74,86,-12
E08000012,Liverpool,90+,40,75,-35
E06000032,Luton,0-4,834,1071,-237
E06000032,Luton,05-Sep,523,818,-295
E06000032,Luton,41913,347,653,-306
E06000032,Luton,15-19,403,970,-567
E06000032,Luton,20-24,1756,2089,-333
E06000032,Luton,25-29,1246,1758,-512
E06000032,Luton,30-34,1171,1490,-319
E06000032,Luton,35-39,825,1122,-297
E06000032,Luton,40-44,526,780,-254
E06000032,Luton,45-49,388,653,-265
E06000032,Luton,50-54,308,547,-239
E06000032,Luton,55-59,203,385,-182
E06000032,Luton,60-64,141,313,-172
E06000032,Luton,65-69,98,210,-112
E06000032,Luton,70-74,52,146,-94
E06000032,Luton,75-79,58,91,-33
E06000032,Luton,80-84,48,58,-10
E06000032,Luton,85-89,32,42,-10
E06000032,Luton,90+,26,33,-7
E07000110,Maidstone,0-4,685,489,196
E07000110,Maidstone,05-Sep,538,357,181
E07000110,Maidstone,41913,433,284,149
E07000110,Maidstone,15-19,316,887,-571
E07000110,Maidstone,20-24,1346,985,361
E07000110,Maidstone,25-29,1214,1192,22
E07000110,Maidstone,30-34,1091,851,240
E07000110,Maidstone,35-39,861,608,253
E07000110,Maidstone,40-44,626,442,184
E07000110,Maidstone,45-49,511,467,44
E07000110,Maidstone,50-54,483,436,47
E07000110,Maidstone,55-59,405,369,36
E07000110,Maidstone,60-64,279,310,-31
E07000110,Maidstone,65-69,249,227,22
E07000110,Maidstone,70-74,226,183,43
E07000110,Maidstone,75-79,108,104,4
E07000110,Maidstone,80-84,112,72,40
E07000110,Maidstone,85-89,107,73,34
E07000110,Maidstone,90+,97,62,35
E07000074,Maldon,0-4,220,165,55
E07000074,Maldon,05-Sep,154,101,53
E07000074,Maldon,41913,129,106,23
E07000074,Maldon,15-19,132,353,-221
E07000074,Maldon,20-24,478,391,87
E07000074,Maldon,25-29,338,403,-65
E07000074,Maldon,30-34,322,244,78
E07000074,Maldon,35-39,240,174,66
E07000074,Maldon,40-44,238,138,100
E07000074,Maldon,45-49,193,152,41
E07000074,Maldon,50-54,235,197,38
E07000074,Maldon,55-59,249,154,95
E07000074,Maldon,60-64,181,142,39
E07000074,Maldon,65-69,128,120,8
E07000074,Maldon,70-74,103,99,4
E07000074,Maldon,75-79,66,51,15
E07000074,Maldon,80-84,41,29,12
E07000074,Maldon,85-89,67,45,22
E07000074,Maldon,90+,45,23,22
E07000235,Malvern Hills,0-4,285,147,138
E07000235,Malvern Hills,05-Sep,265,131,134
E07000235,Malvern Hills,41913,271,152,119
E07000235,Malvern Hills,15-19,219,594,-375
E07000235,Malvern Hills,20-24,646,653,-7
E07000235,Malvern Hills,25-29,478,447,31
E07000235,Malvern Hills,30-34,414,316,98
E07000235,Malvern Hills,35-39,355,215,140
E07000235,Malvern Hills,40-44,320,154,166
E07000235,Malvern Hills,45-49,313,190,123
E07000235,Malvern Hills,50-54,313,228,85
E07000235,Malvern Hills,55-59,329,191,138
E07000235,Malvern Hills,60-64,269,184,85
E07000235,Malvern Hills,65-69,216,152,64
E07000235,Malvern Hills,70-74,215,136,79
E07000235,Malvern Hills,75-79,109,95,14
E07000235,Malvern Hills,80-84,106,68,38
E07000235,Malvern Hills,85-89,85,52,33
E07000235,Malvern Hills,90+,109,56,53
E08000003,Manchester,0-4,1673,2544,-871
E08000003,Manchester,05-Sep,1098,1806,-708
E08000003,Manchester,41913,806,1232,-426
E08000003,Manchester,15-19,6890,1960,4930
E08000003,Manchester,20-24,12598,14266,-1668
E08000003,Manchester,25-29,7242,8176,-934
E08000003,Manchester,30-34,4223,6077,-1854
E08000003,Manchester,35-39,2623,3956,-1333
E08000003,Manchester,40-44,1459,2380,-921
E08000003,Manchester,45-49,1152,1438,-286
E08000003,Manchester,50-54,870,1118,-248
E08000003,Manchester,55-59,591,780,-189
E08000003,Manchester,60-64,351,524,-173
E08000003,Manchester,65-69,220,339,-119
E08000003,Manchester,70-74,157,270,-113
E08000003,Manchester,75-79,82,175,-93
E08000003,Manchester,80-84,106,113,-7
E08000003,Manchester,85-89,61,133,-72
E08000003,Manchester,90+,66,69,-3
E07000174,Mansfield,0-4,382,385,-3
E07000174,Mansfield,05-Sep,267,279,-12
E07000174,Mansfield,41913,208,230,-22
E07000174,Mansfield,15-19,227,446,-219
E07000174,Mansfield,20-24,814,699,115
E07000174,Mansfield,25-29,724,642,82
E07000174,Mansfield,30-34,527,534,-7
E07000174,Mansfield,35-39,354,380,-26
E07000174,Mansfield,40-44,324,305,19
E07000174,Mansfield,45-49,286,264,22
E07000174,Mansfield,50-54,285,238,47
E07000174,Mansfield,55-59,253,228,25
E07000174,Mansfield,60-64,153,148,5
E07000174,Mansfield,65-69,136,100,36
E07000174,Mansfield,70-74,97,71,26
E07000174,Mansfield,75-79,63,50,13
E07000174,Mansfield,80-84,53,32,21
E07000174,Mansfield,85-89,56,31,25
E07000174,Mansfield,90+,34,41,-7
E06000035,Medway,0-4,1008,911,97
E06000035,Medway,05-Sep,777,656,121
E06000035,Medway,41913,520,540,-20
E06000035,Medway,15-19,832,1327,-495
E06000035,Medway,20-24,2224,2428,-204
E06000035,Medway,25-29,1689,1663,26
E06000035,Medway,30-34,1387,1233,154
E06000035,Medway,35-39,1018,973,45
E06000035,Medway,40-44,680,726,-46
E06000035,Medway,45-49,583,660,-77
E06000035,Medway,50-54,500,659,-159
E06000035,Medway,55-59,363,504,-141
E06000035,Medway,60-64,222,423,-201
E06000035,Medway,65-69,163,310,-147
E06000035,Medway,70-74,131,220,-89
E06000035,Medway,75-79,86,121,-35
E06000035,Medway,80-84,82,105,-23
E06000035,Medway,85-89,84,73,11
E06000035,Medway,90+,43,55,-12
E07000133,Melton,0-4,165,119,46
E07000133,Melton,05-Sep,139,82,57
E07000133,Melton,41913,105,91,14
E07000133,Melton,15-19,121,281,-160
E07000133,Melton,20-24,407,305,102
E07000133,Melton,25-29,279,293,-14
E07000133,Melton,30-34,225,193,32
E07000133,Melton,35-39,163,118,45
E07000133,Melton,40-44,154,130,24
E07000133,Melton,45-49,174,134,40
E07000133,Melton,50-54,171,128,43
E07000133,Melton,55-59,133,114,19
E07000133,Melton,60-64,89,76,13
E07000133,Melton,65-69,90,74,16
E07000133,Melton,70-74,90,65,25
E07000133,Melton,75-79,41,40,1
E07000133,Melton,80-84,17,33,-16
E07000133,Melton,85-89,25,33,-8
E07000133,Melton,90+,27,22,5
E07000187,Mendip,0-4,458,259,199
E07000187,Mendip,05-Sep,330,220,110
E07000187,Mendip,41913,415,260,155
E07000187,Mendip,15-19,403,822,-419
E07000187,Mendip,20-24,943,910,33
E07000187,Mendip,25-29,753,691,62
E07000187,Mendip,30-34,616,487,129
E07000187,Mendip,35-39,542,307,235
E07000187,Mendip,40-44,421,310,111
E07000187,Mendip,45-49,418,324,94
E07000187,Mendip,50-54,424,316,108
E07000187,Mendip,55-59,365,270,95
E07000187,Mendip,60-64,274,246,28
E07000187,Mendip,65-69,247,184,63
E07000187,Mendip,70-74,188,138,50
E07000187,Mendip,75-79,97,86,11
E07000187,Mendip,80-84,97,54,43
E07000187,Mendip,85-89,85,74,11
E07000187,Mendip,90+,71,58,13
E09000024,Merton,0-4,973,1592,-619
E09000024,Merton,05-Sep,573,965,-392
E09000024,Merton,41913,418,607,-189
E09000024,Merton,15-19,478,1207,-729
E09000024,Merton,20-24,3107,2143,964
E09000024,Merton,25-29,3278,3250,28
E09000024,Merton,30-34,2847,3249,-402
E09000024,Merton,35-39,2005,2299,-294
E09000024,Merton,40-44,1064,1484,-420
E09000024,Merton,45-49,675,882,-207
E09000024,Merton,50-54,541,685,-144
E09000024,Merton,55-59,402,517,-115
E09000024,Merton,60-64,210,341,-131
E09000024,Merton,65-69,142,255,-113
E09000024,Merton,70-74,106,194,-88
E09000024,Merton,75-79,66,111,-45
E09000024,Merton,80-84,76,93,-17
E09000024,Merton,85-89,58,60,-2
E09000024,Merton,90+,46,69,-23
E07000042,Mid Devon,0-4,334,195,139
E07000042,Mid Devon,05-Sep,279,176,103
E07000042,Mid Devon,41913,271,121,150
E07000042,Mid Devon,15-19,260,441,-181
E07000042,Mid Devon,20-24,749,656,93
E07000042,Mid Devon,25-29,552,484,68
E07000042,Mid Devon,30-34,468,376,92
E07000042,Mid Devon,35-39,373,281,92
E07000042,Mid Devon,40-44,299,202,97
E07000042,Mid Devon,45-49,325,226,99
E07000042,Mid Devon,50-54,351,230,121
E07000042,Mid Devon,55-59,280,210,70
E07000042,Mid Devon,60-64,212,177,35
E07000042,Mid Devon,65-69,205,175,30
E07000042,Mid Devon,70-74,150,149,1
E07000042,Mid Devon,75-79,71,113,-42
E07000042,Mid Devon,80-84,49,72,-23
E07000042,Mid Devon,85-89,40,61,-21
E07000042,Mid Devon,90+,38,41,-3
E07000203,Mid Suffolk,0-4,363,301,62
E07000203,Mid Suffolk,05-Sep,316,237,79
E07000203,Mid Suffolk,41913,228,188,40
E07000203,Mid Suffolk,15-19,255,633,-378
E07000203,Mid Suffolk,20-24,865,705,160
E07000203,Mid Suffolk,25-29,744,598,146
E07000203,Mid Suffolk,30-34,614,396,218
E07000203,Mid Suffolk,35-39,439,297,142
E07000203,Mid Suffolk,40-44,317,209,108
E07000203,Mid Suffolk,45-49,346,273,73
E07000203,Mid Suffolk,50-54,381,288,93
E07000203,Mid Suffolk,55-59,343,218,125
E07000203,Mid Suffolk,60-64,309,205,104
E07000203,Mid Suffolk,65-69,258,186,72
E07000203,Mid Suffolk,70-74,204,167,37
E07000203,Mid Suffolk,75-79,92,100,-8
E07000203,Mid Suffolk,80-84,73,77,-4
E07000203,Mid Suffolk,85-89,90,52,38
E07000203,Mid Suffolk,90+,75,45,30
E07000228,Mid Sussex,0-4,566,384,182
E07000228,Mid Sussex,05-Sep,399,264,135
E07000228,Mid Sussex,41913,295,279,16
E07000228,Mid Sussex,15-19,266,903,-637
E07000228,Mid Sussex,20-24,1223,995,228
E07000228,Mid Sussex,25-29,1036,861,175
E07000228,Mid Sussex,30-34,972,782,190
E07000228,Mid Sussex,35-39,768,523,245
E07000228,Mid Sussex,40-44,576,393,183
E07000228,Mid Sussex,45-49,470,387,83
E07000228,Mid Sussex,50-54,392,373,19
E07000228,Mid Sussex,55-59,323,354,-31
E07000228,Mid Sussex,60-64,203,253,-50
E07000228,Mid Sussex,65-69,181,186,-5
E07000228,Mid Sussex,70-74,173,169,4
E07000228,Mid Sussex,75-79,121,81,40
E07000228,Mid Sussex,80-84,117,73,44
E07000228,Mid Sussex,85-89,133,66,67
E07000228,Mid Sussex,90+,95,105,-10
E06000002,Middlesbrough,0-4,449,519,-70
E06000002,Middlesbrough,05-Sep,340,395,-55
E06000002,Middlesbrough,41913,204,339,-135
E06000002,Middlesbrough,15-19,736,590,146
E06000002,Middlesbrough,20-24,1523,2018,-495
E06000002,Middlesbrough,25-29,908,1198,-290
E06000002,Middlesbrough,30-34,613,843,-230
E06000002,Middlesbrough,35-39,421,562,-141
E06000002,Middlesbrough,40-44,299,367,-68
E06000002,Middlesbrough,45-49,261,350,-89
E06000002,Middlesbrough,50-54,214,276,-62
E06000002,Middlesbrough,55-59,168,218,-50
E06000002,Middlesbrough,60-64,126,152,-26
E06000002,Middlesbrough,65-69,82,129,-47
E06000002,Middlesbrough,70-74,73,80,-7
E06000002,Middlesbrough,75-79,53,41,12
E06000002,Middlesbrough,80-84,50,43,7
E06000002,Middlesbrough,85-89,43,43,0
E06000002,Middlesbrough,90+,36,24,12
E06000042,Milton Keynes,0-4,1030,893,137
E06000042,Milton Keynes,05-Sep,675,713,-38
E06000042,Milton Keynes,41913,476,560,-84
E06000042,Milton Keynes,15-19,439,1537,-1098
E06000042,Milton Keynes,20-24,2374,1708,666
E06000042,Milton Keynes,25-29,1804,1781,23
E06000042,Milton Keynes,30-34,1648,1525,123
E06000042,Milton Keynes,35-39,1229,1209,20
E06000042,Milton Keynes,40-44,772,847,-75
E06000042,Milton Keynes,45-49,620,764,-144
E06000042,Milton Keynes,50-54,460,619,-159
E06000042,Milton Keynes,55-59,369,567,-198
E06000042,Milton Keynes,60-64,250,373,-123
E06000042,Milton Keynes,65-69,184,234,-50
E06000042,Milton Keynes,70-74,154,162,-8
E06000042,Milton Keynes,75-79,107,105,2
E06000042,Milton Keynes,80-84,92,60,32
E06000042,Milton Keynes,85-89,85,37,48
E06000042,Milton Keynes,90+,73,30,43
E07000210,Mole Valley,0-4,340,262,78
E07000210,Mole Valley,05-Sep,220,192,28
E07000210,Mole Valley,41913,207,184,23
E07000210,Mole Valley,15-19,217,639,-422
E07000210,Mole Valley,20-24,951,786,165
E07000210,Mole Valley,25-29,647,722,-75
E07000210,Mole Valley,30-34,589,489,100
E07000210,Mole Valley,35-39,483,395,88
E07000210,Mole Valley,40-44,351,315,36
E07000210,Mole Valley,45-49,318,296,22
E07000210,Mole Valley,50-54,273,272,1
E07000210,Mole Valley,55-59,242,233,9
E07000210,Mole Valley,60-64,155,177,-22
E07000210,Mole Valley,65-69,97,109,-12
E07000210,Mole Valley,70-74,101,111,-10
E07000210,Mole Valley,75-79,71,76,-5
E07000210,Mole Valley,80-84,67,66,1
E07000210,Mole Valley,85-89,58,69,-11
E07000210,Mole Valley,90+,61,68,-7
E07000091,New Forest,0-4,503,325,178
E07000091,New Forest,05-Sep,384,276,108
E07000091,New Forest,41913,301,291,10
E07000091,New Forest,15-19,298,825,-527
E07000091,New Forest,20-24,1194,1113,81
E07000091,New Forest,25-29,945,960,-15
E07000091,New Forest,30-34,723,669,54
E07000091,New Forest,35-39,586,503,83
E07000091,New Forest,40-44,457,351,106
E07000091,New Forest,45-49,416,419,-3
E07000091,New Forest,50-54,474,398,76
E07000091,New Forest,55-59,486,399,87
E07000091,New Forest,60-64,421,322,99
E07000091,New Forest,65-69,406,223,183
E07000091,New Forest,70-74,318,205,113
E07000091,New Forest,75-79,186,136,50
E07000091,New Forest,80-84,145,146,-1
E07000091,New Forest,85-89,140,120,20
E07000091,New Forest,90+,128,117,11
E07000175,Newark and Sherwood,0-4,421,280,141
E07000175,Newark and Sherwood,05-Sep,322,218,104
E07000175,Newark and Sherwood,41913,249,233,16
E07000175,Newark and Sherwood,15-19,398,560,-162
E07000175,Newark and Sherwood,20-24,1049,1080,-31
E07000175,Newark and Sherwood,25-29,815,705,110
E07000175,Newark and Sherwood,30-34,611,534,77
E07000175,Newark and Sherwood,35-39,478,369,109
E07000175,Newark and Sherwood,40-44,366,318,48
E07000175,Newark and Sherwood,45-49,395,286,109
E07000175,Newark and Sherwood,50-54,357,287,70
E07000175,Newark and Sherwood,55-59,291,274,17
E07000175,Newark and Sherwood,60-64,277,185,92
E07000175,Newark and Sherwood,65-69,196,170,26
E07000175,Newark and Sherwood,70-74,129,130,-1
E07000175,Newark and Sherwood,75-79,94,81,13
E07000175,Newark and Sherwood,80-84,62,71,-9
E07000175,Newark and Sherwood,85-89,61,74,-13
E07000175,Newark and Sherwood,90+,59,47,12
E08000021,Newcastle upon Tyne,0-4,779,869,-90
E08000021,Newcastle upon Tyne,05-Sep,418,554,-136
E08000021,Newcastle upon Tyne,41913,336,472,-136
E08000021,Newcastle upon Tyne,15-19,5691,1004,4687
E08000021,Newcastle upon Tyne,20-24,7598,9873,-2275
E08000021,Newcastle upon Tyne,25-29,2911,3758,-847
E08000021,Newcastle upon Tyne,30-34,1743,2270,-527
E08000021,Newcastle upon Tyne,35-39,1209,1456,-247
E08000021,Newcastle upon Tyne,40-44,728,818,-90
E08000021,Newcastle upon Tyne,45-49,554,611,-57
E08000021,Newcastle upon Tyne,50-54,434,543,-109
E08000021,Newcastle upon Tyne,55-59,336,464,-128
E08000021,Newcastle upon Tyne,60-64,240,305,-65
E08000021,Newcastle upon Tyne,65-69,155,208,-53
E08000021,Newcastle upon Tyne,70-74,129,156,-27
E08000021,Newcastle upon Tyne,75-79,110,67,43
E08000021,Newcastle upon Tyne,80-84,85,75,10
E08000021,Newcastle upon Tyne,85-89,68,67,1
E08000021,Newcastle upon Tyne,90+,57,37,20
E07000195,Newcastle-under-Lyme,0-4,406,347,59
E07000195,Newcastle-under-Lyme,05-Sep,266,237,29
E07000195,Newcastle-under-Lyme,41913,250,189,61
E07000195,Newcastle-under-Lyme,15-19,1378,564,814
E07000195,Newcastle-under-Lyme,20-24,1943,2477,-534
E07000195,Newcastle-under-Lyme,25-29,858,915,-57
E07000195,Newcastle-under-Lyme,30-34,660,620,40
E07000195,Newcastle-under-Lyme,35-39,465,449,16
E07000195,Newcastle-under-Lyme,40-44,402,311,91
E07000195,Newcastle-under-Lyme,45-49,314,290,24
E07000195,Newcastle-under-Lyme,50-54,266,259,7
E07000195,Newcastle-under-Lyme,55-59,237,206,31
E07000195,Newcastle-under-Lyme,60-64,166,175,-9
E07000195,Newcastle-under-Lyme,65-69,127,135,-8
E07000195,Newcastle-under-Lyme,70-74,107,103,4
E07000195,Newcastle-under-Lyme,75-79,67,73,-6
E07000195,Newcastle-under-Lyme,80-84,66,68,-2
E07000195,Newcastle-under-Lyme,85-89,63,63,0
E07000195,Newcastle-under-Lyme,90+,42,64,-22
E09000025,Newham,0-4,1590,2983,-1393
E09000025,Newham,05-Sep,973,1835,-862
E09000025,Newham,41913,717,1308,-591
E09000025,Newham,15-19,971,1513,-542
E09000025,Newham,20-24,4681,4202,479
E09000025,Newham,25-29,4845,5505,-660
E09000025,Newham,30-34,3671,5208,-1537
E09000025,Newham,35-39,2290,3607,-1317
E09000025,Newham,40-44,1304,2119,-815
E09000025,Newham,45-49,916,1375,-459
E09000025,Newham,50-54,626,1001,-375
E09000025,Newham,55-59,422,708,-286
E09000025,Newham,60-64,259,473,-214
E09000025,Newham,65-69,125,304,-179
E09000025,Newham,70-74,78,192,-114
E09000025,Newham,75-79,59,109,-50
E09000025,Newham,80-84,44,68,-24
E09000025,Newham,85-89,37,50,-13
E09000025,Newham,90+,18,42,-24
E07000043,North Devon,0-4,295,218,77
E07000043,North Devon,05-Sep,311,196,115
E07000043,North Devon,41913,226,172,54
E07000043,North Devon,15-19,184,446,-262
E07000043,North Devon,20-24,681,770,-89
E07000043,North Devon,25-29,524,545,-21
E07000043,North Devon,30-34,412,353,59
E07000043,North Devon,35-39,320,259,61
E07000043,North Devon,40-44,290,182,108
E07000043,North Devon,45-49,357,214,143
E07000043,North Devon,50-54,374,260,114
E07000043,North Devon,55-59,345,252,93
E07000043,North Devon,60-64,312,168,144
E07000043,North Devon,65-69,227,178,49
E07000043,North Devon,70-74,189,117,72
E07000043,North Devon,75-79,129,93,36
E07000043,North Devon,80-84,90,59,31
E07000043,North Devon,85-89,68,39,29
E07000043,North Devon,90+,51,40,11
E07000050,North Dorset,0-4,310,310,0
E07000050,North Dorset,05-Sep,226,231,-5
E07000050,North Dorset,41913,376,214,162
E07000050,North Dorset,15-19,304,658,-354
E07000050,North Dorset,20-24,483,555,-72
E07000050,North Dorset,25-29,399,510,-111
E07000050,North Dorset,30-34,397,335,62
E07000050,North Dorset,35-39,338,254,84
E07000050,North Dorset,40-44,220,201,19
E07000050,North Dorset,45-49,231,223,8
E07000050,North Dorset,50-54,265,219,46
E07000050,North Dorset,55-59,284,220,64
E07000050,North Dorset,60-64,246,175,71
E07000050,North Dorset,65-69,208,165,43
E07000050,North Dorset,70-74,176,138,38
E07000050,North Dorset,75-79,90,75,15
E07000050,North Dorset,80-84,62,72,-10
E07000050,North Dorset,85-89,49,62,-13
E07000050,North Dorset,90+,42,37,5
E07000038,North East Derbyshire,0-4,414,282,132
E07000038,North East Derbyshire,05-Sep,268,211,57
E07000038,North East Derbyshire,41913,210,200,10
E07000038,North East Derbyshire,15-19,194,449,-255
E07000038,North East Derbyshire,20-24,706,632,74
E07000038,North East Derbyshire,25-29,726,638,88
E07000038,North East Derbyshire,30-34,576,484,92
E07000038,North East Derbyshire,35-39,459,341,118
E07000038,North East Derbyshire,40-44,298,266,32
E07000038,North East Derbyshire,45-49,309,238,71
E07000038,North East Derbyshire,50-54,310,255,55
E07000038,North East Derbyshire,55-59,276,202,74
E07000038,North East Derbyshire,60-64,204,184,20
E07000038,North East Derbyshire,65-69,163,124,39
E07000038,North East Derbyshire,70-74,127,111,16
E07000038,North East Derbyshire,75-79,86,65,21
E07000038,North East Derbyshire,80-84,54,46,8
E07000038,North East Derbyshire,85-89,41,39,2
E07000038,North East Derbyshire,90+,44,40,4
E06000012,North East Lincolnshire,0-4,311,279,32
E06000012,North East Lincolnshire,05-Sep,258,252,6
E06000012,North East Lincolnshire,41913,205,214,-9
E06000012,North East Lincolnshire,15-19,262,576,-314
E06000012,North East Lincolnshire,20-24,841,732,109
E06000012,North East Lincolnshire,25-29,545,627,-82
E06000012,North East Lincolnshire,30-34,334,434,-100
E06000012,North East Lincolnshire,35-39,290,334,-44
E06000012,North East Lincolnshire,40-44,215,222,-7
E06000012,North East Lincolnshire,45-49,205,223,-18
E06000012,North East Lincolnshire,50-54,240,225,15
E06000012,North East Lincolnshire,55-59,219,194,25
E06000012,North East Lincolnshire,60-64,174,140,34
E06000012,North East Lincolnshire,65-69,119,105,14
E06000012,North East Lincolnshire,70-74,112,81,31
E06000012,North East Lincolnshire,75-79,85,59,26
E06000012,North East Lincolnshire,80-84,43,31,12
E06000012,North East Lincolnshire,85-89,25,33,-8
E06000012,North East Lincolnshire,90+,28,9,19
E07000099,North Hertfordshire,0-4,548,511,37
E07000099,North Hertfordshire,05-Sep,302,326,-24
E07000099,North Hertfordshire,41913,232,277,-45
E07000099,North Hertfordshire,15-19,226,832,-606
E07000099,North Hertfordshire,20-24,1333,1066,267
E07000099,North Hertfordshire,25-29,1136,1054,82
E07000099,North Hertfordshire,30-34,1106,976,130
E07000099,North Hertfordshire,35-39,820,716,104
E07000099,North Hertfordshire,40-44,529,453,76
E07000099,North Hertfordshire,45-49,363,460,-97
E07000099,North Hertfordshire,50-54,298,413,-115
E07000099,North Hertfordshire,55-59,248,328,-80
E07000099,North Hertfordshire,60-64,154,232,-78
E07000099,North Hertfordshire,65-69,123,186,-63
E07000099,North Hertfordshire,70-74,116,108,8
E07000099,North Hertfordshire,75-79,62,58,4
E07000099,North Hertfordshire,80-84,104,78,26
E07000099,North Hertfordshire,85-89,75,53,22
E07000099,North Hertfordshire,90+,86,53,33
E07000139,North Kesteven,0-4,514,349,165
E07000139,North Kesteven,05-Sep,422,290,132
E07000139,North Kesteven,41913,308,217,91
E07000139,North Kesteven,15-19,300,792,-492
E07000139,North Kesteven,20-24,1013,811,202
E07000139,North Kesteven,25-29,915,725,190
E07000139,North Kesteven,30-34,743,476,267
E07000139,North Kesteven,35-39,465,359,106
E07000139,North Kesteven,40-44,341,233,108
E07000139,North Kesteven,45-49,404,362,42
E07000139,North Kesteven,50-54,336,381,-45
E07000139,North Kesteven,55-59,316,285,31
E07000139,North Kesteven,60-64,284,220,64
E07000139,North Kesteven,65-69,300,190,110
E07000139,North Kesteven,70-74,220,196,24
E07000139,North Kesteven,75-79,138,121,17
E07000139,North Kesteven,80-84,86,87,-1
E07000139,North Kesteven,85-89,73,77,-4
E07000139,North Kesteven,90+,56,78,-22
E06000013,North Lincolnshire,0-4,355,302,53
E06000013,North Lincolnshire,05-Sep,255,233,22
E06000013,North Lincolnshire,41913,259,227,32
E06000013,North Lincolnshire,15-19,249,677,-428
E06000013,North Lincolnshire,20-24,957,911,46
E06000013,North Lincolnshire,25-29,676,652,24
E06000013,North Lincolnshire,30-34,503,424,79
E06000013,North Lincolnshire,35-39,409,415,-6
E06000013,North Lincolnshire,40-44,336,267,69
E06000013,North Lincolnshire,45-49,316,306,10
E06000013,North Lincolnshire,50-54,360,285,75
E06000013,North Lincolnshire,55-59,261,235,26
E06000013,North Lincolnshire,60-64,285,193,92
E06000013,North Lincolnshire,65-69,199,160,39
E06000013,North Lincolnshire,70-74,141,160,-19
E06000013,North Lincolnshire,75-79,59,87,-28
E06000013,North Lincolnshire,80-84,57,43,14
E06000013,North Lincolnshire,85-89,35,31,4
E06000013,North Lincolnshire,90+,31,27,4
E07000147,North Norfolk,0-4,259,178,81
E07000147,North Norfolk,05-Sep,223,180,43
E07000147,North Norfolk,41913,196,157,39
E07000147,North Norfolk,15-19,206,447,-241
E07000147,North Norfolk,20-24,640,594,46
E07000147,North Norfolk,25-29,469,498,-29
E07000147,North Norfolk,30-34,379,296,83
E07000147,North Norfolk,35-39,312,234,78
E07000147,North Norfolk,40-44,244,190,54
E07000147,North Norfolk,45-49,303,252,51
E07000147,North Norfolk,50-54,402,203,199
E07000147,North Norfolk,55-59,454,211,243
E07000147,North Norfolk,60-64,457,234,223
E07000147,North Norfolk,65-69,370,227,143
E07000147,North Norfolk,70-74,252,232,20
E07000147,North Norfolk,75-79,120,131,-11
E07000147,North Norfolk,80-84,93,112,-19
E07000147,North Norfolk,85-89,71,88,-17
E07000147,North Norfolk,90+,74,57,17
E06000024,North Somerset,0-4,607,381,226
E06000024,North Somerset,05-Sep,392,301,91
E06000024,North Somerset,41913,305,221,84
E06000024,North Somerset,15-19,305,886,-581
E06000024,North Somerset,20-24,1586,1393,193
E06000024,North Somerset,25-29,1307,1164,143
E06000024,North Somerset,30-34,1057,714,343
E06000024,North Somerset,35-39,895,587,308
E06000024,North Somerset,40-44,644,456,188
E06000024,North Somerset,45-49,480,441,39
E06000024,North Somerset,50-54,507,454,53
E06000024,North Somerset,55-59,455,412,43
E06000024,North Somerset,60-64,349,326,23
E06000024,North Somerset,65-69,276,355,-79
E06000024,North Somerset,70-74,246,219,27
E06000024,North Somerset,75-79,141,139,2
E06000024,North Somerset,80-84,112,102,10
E06000024,North Somerset,85-89,123,99,24
E06000024,North Somerset,90+,101,93,8
E08000022,North Tyneside,0-4,585,474,111
E08000022,North Tyneside,05-Sep,359,262,97
E08000022,North Tyneside,41913,276,227,49
E08000022,North Tyneside,15-19,262,671,-409
E08000022,North Tyneside,20-24,1409,1078,331
E08000022,North Tyneside,25-29,1315,1142,173
E08000022,North Tyneside,30-34,1205,878,327
E08000022,North Tyneside,35-39,844,716,128
E08000022,North Tyneside,40-44,521,439,82
E08000022,North Tyneside,45-49,433,350,83
E08000022,North Tyneside,50-54,361,334,27
E08000022,North Tyneside,55-59,363,276,87
E08000022,North Tyneside,60-64,276,248,28
E08000022,North Tyneside,65-69,234,170,64
E08000022,North Tyneside,70-74,158,116,42
E08000022,North Tyneside,75-79,93,75,18
E08000022,North Tyneside,80-84,68,71,-3
E08000022,North Tyneside,85-89,67,56,11
E08000022,North Tyneside,90+,35,54,-19
E07000218,North Warwickshire,0-4,320,248,72
E07000218,North Warwickshire,05-Sep,271,187,84
E07000218,North Warwickshire,41913,205,127,78
E07000218,North Warwickshire,15-19,171,284,-113
E07000218,North Warwickshire,20-24,577,426,151
E07000218,North Warwickshire,25-29,586,472,114
E07000218,North Warwickshire,30-34,472,322,150
E07000218,North Warwickshire,35-39,317,244,73
E07000218,North Warwickshire,40-44,239,206,33
E07000218,North Warwickshire,45-49,245,194,51
E07000218,North Warwickshire,50-54,215,220,-5
E07000218,North Warwickshire,55-59,193,186,7
E07000218,North Warwickshire,60-64,148,111,37
E07000218,North Warwickshire,65-69,99,117,-18
E07000218,North Warwickshire,70-74,81,75,6
E07000218,North Warwickshire,75-79,50,70,-20
E07000218,North Warwickshire,80-84,65,44,21
E07000218,North Warwickshire,85-89,52,35,17
E07000218,North Warwickshire,90+,64,25,39
E07000134,North West Leicestershire,0-4,485,210,275
E07000134,North West Leicestershire,05-Sep,307,185,122
E07000134,North West Leicestershire,41913,235,155,80
E07000134,North West Leicestershire,15-19,252,494,-242
E07000134,North West Leicestershire,20-24,1097,822,275
E07000134,North West Leicestershire,25-29,873,659,214
E07000134,North West Leicestershire,30-34,714,431,283
E07000134,North West Leicestershire,35-39,517,287,230
E07000134,North West Leicestershire,40-44,362,227,135
E07000134,North West Leicestershire,45-49,391,221,170
E07000134,North West Leicestershire,50-54,344,259,85
E07000134,North West Leicestershire,55-59,298,207,91
E07000134,North West Leicestershire,60-64,209,138,71
E07000134,North West Leicestershire,65-69,185,116,69
E07000134,North West Leicestershire,70-74,125,80,45
E07000134,North West Leicestershire,75-79,67,51,16
E07000134,North West Leicestershire,80-84,45,57,-12
E07000134,North West Leicestershire,85-89,51,38,13
E07000134,North West Leicestershire,90+,23,28,-5
E07000154,Northampton,0-4,565,832,-267
E07000154,Northampton,05-Sep,396,551,-155
E07000154,Northampton,41913,297,516,-219
E07000154,Northampton,15-19,1211,1124,87
E07000154,Northampton,20-24,2403,3321,-918
E07000154,Northampton,25-29,1497,1676,-179
E07000154,Northampton,30-34,1100,1400,-300
E07000154,Northampton,35-39,847,1008,-161
E07000154,Northampton,40-44,565,736,-171
E07000154,Northampton,45-49,462,640,-178
E07000154,Northampton,50-54,388,596,-208
E07000154,Northampton,55-59,294,432,-138
E07000154,Northampton,60-64,218,344,-126
E07000154,Northampton,65-69,171,235,-64
E07000154,Northampton,70-74,122,178,-56
E07000154,Northampton,75-79,84,100,-16
E07000154,Northampton,80-84,74,78,-4
E07000154,Northampton,85-89,68,74,-6
E07000154,Northampton,90+,53,74,-21
E06000057,Northumberland,0-4,823,418,405
E06000057,Northumberland,05-Sep,496,348,148
E06000057,Northumberland,41913,415,314,101
E06000057,Northumberland,15-19,400,1316,-916
E06000057,Northumberland,20-24,1770,1670,100
E06000057,Northumberland,25-29,1192,1243,-51
E06000057,Northumberland,30-34,1063,820,243
E06000057,Northumberland,35-39,943,526,417
E06000057,Northumberland,40-44,641,479,162
E06000057,Northumberland,45-49,635,460,175
E06000057,Northumberland,50-54,726,459,267
E06000057,Northumberland,55-59,758,408,350
E06000057,Northumberland,60-64,599,341,258
E06000057,Northumberland,65-69,476,288,188
E06000057,Northumberland,70-74,327,250,77
E06000057,Northumberland,75-79,167,138,29
E06000057,Northumberland,80-84,137,129,8
E06000057,Northumberland,85-89,94,89,5
E06000057,Northumberland,90+,88,67,21
E07000148,Norwich,0-4,357,649,-292
E07000148,Norwich,05-Sep,270,461,-191
E07000148,Norwich,41913,213,348,-135
E07000148,Norwich,15-19,2907,566,2341
E07000148,Norwich,20-24,3806,4057,-251
E07000148,Norwich,25-29,1823,2314,-491
E07000148,Norwich,30-34,1096,1506,-410
E07000148,Norwich,35-39,712,1023,-311
E07000148,Norwich,40-44,483,683,-200
E07000148,Norwich,45-49,439,515,-76
E07000148,Norwich,50-54,367,393,-26
E07000148,Norwich,55-59,273,302,-29
E07000148,Norwich,60-64,196,238,-42
E07000148,Norwich,65-69,169,194,-25
E07000148,Norwich,70-74,132,141,-9
E07000148,Norwich,75-79,91,80,11
E07000148,Norwich,80-84,59,93,-34
E07000148,Norwich,85-89,59,77,-18
E07000148,Norwich,90+,86,101,-15
E06000018,Nottingham,0-4,934,1278,-344
E06000018,Nottingham,05-Sep,663,876,-213
E06000018,Nottingham,41913,483,676,-193
E06000018,Nottingham,15-19,9286,1246,8040
E06000018,Nottingham,20-24,9775,15531,-5756
E06000018,Nottingham,25-29,3187,4676,-1489
E06000018,Nottingham,30-34,1922,2667,-745
E06000018,Nottingham,35-39,1298,1752,-454
E06000018,Nottingham,40-44,895,1120,-225
E06000018,Nottingham,45-49,726,836,-110
E06000018,Nottingham,50-54,573,593,-20
E06000018,Nottingham,55-59,427,473,-46
E06000018,Nottingham,60-64,257,337,-80
E06000018,Nottingham,65-69,192,263,-71
E06000018,Nottingham,70-74,122,147,-25
E06000018,Nottingham,75-79,80,84,-4
E06000018,Nottingham,80-84,86,98,-12
E06000018,Nottingham,85-89,65,111,-46
E06000018,Nottingham,90+,48,82,-34
E07000219,Nuneaton and Bedworth,0-4,485,459,26
E07000219,Nuneaton and Bedworth,05-Sep,311,337,-26
E07000219,Nuneaton and Bedworth,41913,250,254,-4
E07000219,Nuneaton and Bedworth,15-19,234,508,-274
E07000219,Nuneaton and Bedworth,20-24,909,705,204
E07000219,Nuneaton and Bedworth,25-29,824,716,108
E07000219,Nuneaton and Bedworth,30-34,694,620,74
E07000219,Nuneaton and Bedworth,35-39,479,472,7
E07000219,Nuneaton and Bedworth,40-44,350,332,18
E07000219,Nuneaton and Bedworth,45-49,258,272,-14
E07000219,Nuneaton and Bedworth,50-54,273,258,15
E07000219,Nuneaton and Bedworth,55-59,185,239,-54
E07000219,Nuneaton and Bedworth,60-64,127,148,-21
E07000219,Nuneaton and Bedworth,65-69,97,159,-62
E07000219,Nuneaton and Bedworth,70-74,83,110,-27
E07000219,Nuneaton and Bedworth,75-79,43,56,-13
E07000219,Nuneaton and Bedworth,80-84,55,66,-11
E07000219,Nuneaton and Bedworth,85-89,39,49,-10
E07000219,Nuneaton and Bedworth,90+,34,29,5
E07000135,Oadby and Wigston,0-4,295,220,75
E07000135,Oadby and Wigston,05-Sep,265,172,93
E07000135,Oadby and Wigston,41913,167,121,46
E07000135,Oadby and Wigston,15-19,1360,524,836
E07000135,Oadby and Wigston,20-24,976,2196,-1220
E07000135,Oadby and Wigston,25-29,437,513,-76
E07000135,Oadby and Wigston,30-34,405,342,63
E07000135,Oadby and Wigston,35-39,343,253,90
E07000135,Oadby and Wigston,40-44,220,186,34
E07000135,Oadby and Wigston,45-49,185,167,18
E07000135,Oadby and Wigston,50-54,118,140,-22
E07000135,Oadby and Wigston,55-59,95,146,-51
E07000135,Oadby and Wigston,60-64,72,93,-21
E07000135,Oadby and Wigston,65-69,60,93,-33
E07000135,Oadby and Wigston,70-74,66,61,5
E07000135,Oadby and Wigston,75-79,33,35,-2
E07000135,Oadby and Wigston,80-84,65,39,26
E07000135,Oadby and Wigston,85-89,45,29,16
E07000135,Oadby and Wigston,90+,42,37,5
E08000004,Oldham,0-4,685,709,-24
E08000004,Oldham,05-Sep,486,484,2
E08000004,Oldham,41913,360,377,-17
E08000004,Oldham,15-19,366,849,-483
E08000004,Oldham,20-24,1398,1089,309
E08000004,Oldham,25-29,1148,1123,25
E08000004,Oldham,30-34,912,864,48
E08000004,Oldham,35-39,695,663,32
E08000004,Oldham,40-44,417,407,10
E08000004,Oldham,45-49,408,425,-17
E08000004,Oldham,50-54,317,389,-72
E08000004,Oldham,55-59,228,303,-75
E08000004,Oldham,60-64,163,225,-62
E08000004,Oldham,65-69,132,211,-79
E08000004,Oldham,70-74,91,115,-24
E08000004,Oldham,75-79,71,62,9
E08000004,Oldham,80-84,42,36,6
E08000004,Oldham,85-89,49,26,23
E08000004,Oldham,90+,25,21,4
E07000178,Oxford,0-4,317,660,-343
E07000178,Oxford,05-Sep,260,390,-130
E07000178,Oxford,41913,310,421,-111
E07000178,Oxford,15-19,4281,1094,3187
E07000178,Oxford,20-24,5511,7695,-2184
E07000178,Oxford,25-29,2390,3607,-1217
E07000178,Oxford,30-34,1357,2231,-874
E07000178,Oxford,35-39,777,1323,-546
E07000178,Oxford,40-44,464,736,-272
E07000178,Oxford,45-49,325,489,-164
E07000178,Oxford,50-54,284,403,-119
E07000178,Oxford,55-59,204,292,-88
E07000178,Oxford,60-64,127,218,-91
E07000178,Oxford,65-69,113,159,-46
E07000178,Oxford,70-74,75,86,-11
E07000178,Oxford,75-79,58,73,-15
E07000178,Oxford,80-84,41,73,-32
E07000178,Oxford,85-89,47,55,-8
E07000178,Oxford,90+,33,51,-18
E07000122,Pendle,0-4,227,279,-52
E07000122,Pendle,05-Sep,184,194,-10
E07000122,Pendle,41913,137,153,-16
E07000122,Pendle,15-19,149,373,-224
E07000122,Pendle,20-24,591,514,77
E07000122,Pendle,25-29,450,459,-9
E07000122,Pendle,30-34,327,368,-41
E07000122,Pendle,35-39,245,255,-10
E07000122,Pendle,40-44,176,188,-12
E07000122,Pendle,45-49,215,186,29
E07000122,Pendle,50-54,184,166,18
E07000122,Pendle,55-59,186,164,22
E07000122,Pendle,60-64,133,137,-4
E07000122,Pendle,65-69,91,101,-10
E07000122,Pendle,70-74,57,64,-7
E07000122,Pendle,75-79,43,60,-17
E07000122,Pendle,80-84,27,48,-21
E07000122,Pendle,85-89,36,28,8
E07000122,Pendle,90+,12,22,-10
E06000031,Peterborough,0-4,752,718,34
E06000031,Peterborough,05-Sep,558,493,65
E06000031,Peterborough,41913,388,430,-42
E06000031,Peterborough,15-19,393,1016,-623
E06000031,Peterborough,20-24,1634,1459,175
E06000031,Peterborough,25-29,1435,1414,21
E06000031,Peterborough,30-34,1070,1104,-34
E06000031,Peterborough,35-39,777,783,-6
E06000031,Peterborough,40-44,571,540,31
E06000031,Peterborough,45-49,450,489,-39
E06000031,Peterborough,50-54,453,428,25
E06000031,Peterborough,55-59,317,367,-50
E06000031,Peterborough,60-64,216,240,-24
E06000031,Peterborough,65-69,139,187,-48
E06000031,Peterborough,70-74,131,148,-17
E06000031,Peterborough,75-79,88,79,9
E06000031,Peterborough,80-84,83,60,23
E06000031,Peterborough,85-89,42,50,-8
E06000031,Peterborough,90+,57,42,15
E06000026,Plymouth,0-4,597,675,-78
E06000026,Plymouth,05-Sep,432,507,-75
E06000026,Plymouth,41913,328,349,-21
E06000026,Plymouth,15-19,2764,739,2025
E06000026,Plymouth,20-24,4328,5623,-1295
E06000026,Plymouth,25-29,1671,2259,-588
E06000026,Plymouth,30-34,1044,1192,-148
E06000026,Plymouth,35-39,768,858,-90
E06000026,Plymouth,40-44,521,560,-39
E06000026,Plymouth,45-49,515,532,-17
E06000026,Plymouth,50-54,421,443,-22
E06000026,Plymouth,55-59,366,432,-66
E06000026,Plymouth,60-64,256,313,-57
E06000026,Plymouth,65-69,219,204,15
E06000026,Plymouth,70-74,180,172,8
E06000026,Plymouth,75-79,92,124,-32
E06000026,Plymouth,80-84,90,71,19
E06000026,Plymouth,85-89,74,68,6
E06000026,Plymouth,90+,69,50,19
E06000029,Poole,0-4,609,588,21
E06000029,Poole,05-Sep,411,398,13
E06000029,Poole,41913,405,337,68
E06000029,Poole,15-19,586,837,-251
E06000029,Poole,20-24,1677,2053,-376
E06000029,Poole,25-29,1387,1244,143
E06000029,Poole,30-34,1091,1045,46
E06000029,Poole,35-39,795,763,32
E06000029,Poole,40-44,531,515,16
E06000029,Poole,45-49,501,503,-2
E06000029,Poole,50-54,487,433,54
E06000029,Poole,55-59,390,373,17
E06000029,Poole,60-64,322,312,10
E06000029,Poole,65-69,342,232,110
E06000029,Poole,70-74,241,210,31
E06000029,Poole,75-79,162,117,45
E06000029,Poole,80-84,143,86,57
E06000029,Poole,85-89,119,104,15
E06000029,Poole,90+,97,102,-5
E06000044,Portsmouth,0-4,503,725,-222
E06000044,Portsmouth,05-Sep,310,499,-189
E06000044,Portsmouth,41913,236,370,-134
E06000044,Portsmouth,15-19,3155,660,2495
E06000044,Portsmouth,20-24,4152,5718,-1566
E06000044,Portsmouth,25-29,1594,2174,-580
E06000044,Portsmouth,30-34,1060,1309,-249
E06000044,Portsmouth,35-39,692,957,-265
E06000044,Portsmouth,40-44,456,579,-123
E06000044,Portsmouth,45-49,422,568,-146
E06000044,Portsmouth,50-54,395,466,-71
E06000044,Portsmouth,55-59,329,403,-74
E06000044,Portsmouth,60-64,212,238,-26
E06000044,Portsmouth,65-69,131,193,-62
E06000044,Portsmouth,70-74,124,130,-6
E06000044,Portsmouth,75-79,87,81,6
E06000044,Portsmouth,80-84,79,74,5
E06000044,Portsmouth,85-89,54,56,-2
E06000044,Portsmouth,90+,27,44,-17
E07000123,Preston,0-4,445,395,50
E07000123,Preston,05-Sep,316,318,-2
E07000123,Preston,41913,307,223,84
E07000123,Preston,15-19,1166,534,632
E07000123,Preston,20-24,2399,3199,-800
E07000123,Preston,25-29,1129,1481,-352
E07000123,Preston,30-34,777,822,-45
E07000123,Preston,35-39,584,519,65
E07000123,Preston,40-44,375,358,17
E07000123,Preston,45-49,298,336,-38
E07000123,Preston,50-54,261,246,15
E07000123,Preston,55-59,218,229,-11
E07000123,Preston,60-64,143,163,-20
E07000123,Preston,65-69,99,123,-24
E07000123,Preston,70-74,63,114,-51
E07000123,Preston,75-79,65,63,2
E07000123,Preston,80-84,51,100,-49
E07000123,Preston,85-89,29,64,-35
E07000123,Preston,90+,45,59,-14
E07000051,Purbeck,0-4,228,139,89
E07000051,Purbeck,05-Sep,154,108,46
E07000051,Purbeck,41913,122,93,29
E07000051,Purbeck,15-19,118,253,-135
E07000051,Purbeck,20-24,369,364,5
E07000051,Purbeck,25-29,317,341,-24
E07000051,Purbeck,30-34,274,217,57
E07000051,Purbeck,35-39,237,203,34
E07000051,Purbeck,40-44,160,120,40
E07000051,Purbeck,45-49,187,140,47
E07000051,Purbeck,50-54,200,141,59
E07000051,Purbeck,55-59,185,142,43
E07000051,Purbeck,60-64,190,93,97
E07000051,Purbeck,65-69,151,91,60
E07000051,Purbeck,70-74,101,80,21
E07000051,Purbeck,75-79,51,46,5
E07000051,Purbeck,80-84,41,50,-9
E07000051,Purbeck,85-89,20,46,-26
E07000051,Purbeck,90+,32,44,-12
E06000038,Reading,0-4,451,988,-537
E06000038,Reading,05-Sep,292,628,-336
E06000038,Reading,41913,196,444,-248
E06000038,Reading,15-19,2045,859,1186
E06000038,Reading,20-24,3855,4072,-217
E06000038,Reading,25-29,1988,2293,-305
E06000038,Reading,30-34,1373,2088,-715
E06000038,Reading,35-39,947,1511,-564
E06000038,Reading,40-44,539,868,-329
E06000038,Reading,45-49,333,540,-207
E06000038,Reading,50-54,299,473,-174
E06000038,Reading,55-59,211,351,-140
E06000038,Reading,60-64,118,254,-136
E06000038,Reading,65-69,88,153,-65
E06000038,Reading,70-74,66,107,-41
E06000038,Reading,75-79,48,62,-14
E06000038,Reading,80-84,42,54,-12
E06000038,Reading,85-89,50,52,-2
E06000038,Reading,90+,30,59,-29
E09000026,Redbridge,0-4,1966,2630,-664
E09000026,Redbridge,05-Sep,1296,1706,-410
E09000026,Redbridge,41913,898,1234,-336
E09000026,Redbridge,15-19,753,2008,-1255
E09000026,Redbridge,20-24,2943,2428,515
E09000026,Redbridge,25-29,2884,3304,-420
E09000026,Redbridge,30-34,2938,3611,-673
E09000026,Redbridge,35-39,2360,2807,-447
E09000026,Redbridge,40-44,1361,1698,-337
E09000026,Redbridge,45-49,901,1129,-228
E09000026,Redbridge,50-54,645,839,-194
E09000026,Redbridge,55-59,446,631,-185
E09000026,Redbridge,60-64,352,519,-167
E09000026,Redbridge,65-69,215,398,-183
E09000026,Redbridge,70-74,135,251,-116
E09000026,Redbridge,75-79,119,170,-51
E09000026,Redbridge,80-84,84,138,-54
E09000026,Redbridge,85-89,62,130,-68
E09000026,Redbridge,90+,48,118,-70
E06000003,Redcar and Cleveland,0-4,346,297,49
E06000003,Redcar and Cleveland,05-Sep,300,218,82
E06000003,Redcar and Cleveland,41913,212,169,43
E06000003,Redcar and Cleveland,15-19,233,459,-226
E06000003,Redcar and Cleveland,20-24,755,689,66
E06000003,Redcar and Cleveland,25-29,595,599,-4
E06000003,Redcar and Cleveland,30-34,482,394,88
E06000003,Redcar and Cleveland,35-39,353,300,53
E06000003,Redcar and Cleveland,40-44,239,216,23
E06000003,Redcar and Cleveland,45-49,251,218,33
E06000003,Redcar and Cleveland,50-54,260,212,48
E06000003,Redcar and Cleveland,55-59,255,135,120
E06000003,Redcar and Cleveland,60-64,219,107,112
E06000003,Redcar and Cleveland,65-69,151,98,53
E06000003,Redcar and Cleveland,70-74,109,69,40
E06000003,Redcar and Cleveland,75-79,82,42,40
E06000003,Redcar and Cleveland,80-84,54,47,7
E06000003,Redcar and Cleveland,85-89,52,45,7
E06000003,Redcar and Cleveland,90+,45,30,15
E07000236,Redditch,0-4,199,245,-46
E07000236,Redditch,05-Sep,140,174,-34
E07000236,Redditch,41913,118,144,-26
E07000236,Redditch,15-19,125,319,-194
E07000236,Redditch,20-24,530,445,85
E07000236,Redditch,25-29,458,384,74
E07000236,Redditch,30-34,324,368,-44
E07000236,Redditch,35-39,255,268,-13
E07000236,Redditch,40-44,157,232,-75
E07000236,Redditch,45-49,176,193,-17
E07000236,Redditch,50-54,113,157,-44
E07000236,Redditch,55-59,97,136,-39
E07000236,Redditch,60-64,66,130,-64
E07000236,Redditch,65-69,46,87,-41
E07000236,Redditch,70-74,51,95,-44
E07000236,Redditch,75-79,31,58,-27
E07000236,Redditch,80-84,34,34,0
E07000236,Redditch,85-89,29,39,-10
E07000236,Redditch,90+,19,36,-17
E07000211,Reigate and Banstead,0-4,703,540,163
E07000211,Reigate and Banstead,05-Sep,489,430,59
E07000211,Reigate and Banstead,41913,348,272,76
E07000211,Reigate and Banstead,15-19,302,972,-670
E07000211,Reigate and Banstead,20-24,1494,1041,453
E07000211,Reigate and Banstead,25-29,1320,1094,226
E07000211,Reigate and Banstead,30-34,1281,978,303
E07000211,Reigate and Banstead,35-39,875,790,85
E07000211,Reigate and Banstead,40-44,601,532,69
E07000211,Reigate and Banstead,45-49,452,403,49
E07000211,Reigate and Banstead,50-54,390,453,-63
E07000211,Reigate and Banstead,55-59,320,409,-89
E07000211,Reigate and Banstead,60-64,246,275,-29
E07000211,Reigate and Banstead,65-69,160,217,-57
E07000211,Reigate and Banstead,70-74,135,160,-25
E07000211,Reigate and Banstead,75-79,118,102,16
E07000211,Reigate and Banstead,80-84,105,105,0
E07000211,Reigate and Banstead,85-89,124,61,63
E07000211,Reigate and Banstead,90+,118,76,42
E07000124,Ribble Valley,0-4,200,122,78
E07000124,Ribble Valley,05-Sep,187,95,92
E07000124,Ribble Valley,41913,160,98,62
E07000124,Ribble Valley,15-19,155,439,-284
E07000124,Ribble Valley,20-24,502,440,62
E07000124,Ribble Valley,25-29,345,310,35
E07000124,Ribble Valley,30-34,304,255,49
E07000124,Ribble Valley,35-39,245,179,66
E07000124,Ribble Valley,40-44,222,109,113
E07000124,Ribble Valley,45-49,207,132,75
E07000124,Ribble Valley,50-54,212,138,74
E07000124,Ribble Valley,55-59,192,126,66
E07000124,Ribble Valley,60-64,154,104,50
E07000124,Ribble Valley,65-69,112,93,19
E07000124,Ribble Valley,70-74,85,77,8
E07000124,Ribble Valley,75-79,67,53,14
E07000124,Ribble Valley,80-84,57,25,32
E07000124,Ribble Valley,85-89,46,29,17
E07000124,Ribble Valley,90+,32,27,5
E09000027,Richmond upon Thames,0-4,899,996,-97
E09000027,Richmond upon Thames,05-Sep,415,559,-144
E09000027,Richmond upon Thames,41913,341,441,-100
E09000027,Richmond upon Thames,15-19,696,1409,-713
E09000027,Richmond upon Thames,20-24,2765,2333,432
E09000027,Richmond upon Thames,25-29,2302,2063,239
E09000027,Richmond upon Thames,30-34,2301,2043,258
E09000027,Richmond upon Thames,35-39,1742,1674,68
E09000027,Richmond upon Thames,40-44,1032,1142,-110
E09000027,Richmond upon Thames,45-49,660,786,-126
E09000027,Richmond upon Thames,50-54,520,592,-72
E09000027,Richmond upon Thames,55-59,354,424,-70
E09000027,Richmond upon Thames,60-64,227,295,-68
E09000027,Richmond upon Thames,65-69,177,236,-59
E09000027,Richmond upon Thames,70-74,145,222,-77
E09000027,Richmond upon Thames,75-79,74,118,-44
E09000027,Richmond upon Thames,80-84,71,95,-24
E09000027,Richmond upon Thames,85-89,56,70,-14
E09000027,Richmond upon Thames,90+,29,90,-61
E07000166,Richmondshire,0-4,314,348,-34
E07000166,Richmondshire,05-Sep,221,255,-34
E07000166,Richmondshire,41913,151,163,-12
E07000166,Richmondshire,15-19,136,375,-239
E07000166,Richmondshire,20-24,366,419,-53
E07000166,Richmondshire,25-29,315,386,-71
E07000166,Richmondshire,30-34,247,320,-73
E07000166,Richmondshire,35-39,181,181,0
E07000166,Richmondshire,40-44,146,140,6
E07000166,Richmondshire,45-49,154,149,5
E07000166,Richmondshire,50-54,161,159,2
E07000166,Richmondshire,55-59,197,109,88
E07000166,Richmondshire,60-64,166,106,60
E07000166,Richmondshire,65-69,135,103,32
E07000166,Richmondshire,70-74,74,90,-16
E07000166,Richmondshire,75-79,42,49,-7
E07000166,Richmondshire,80-84,42,42,0
E07000166,Richmondshire,85-89,33,35,-2
E07000166,Richmondshire,90+,21,18,3
E08000005,Rochdale,0-4,706,660,46
E08000005,Rochdale,05-Sep,460,486,-26
E08000005,Rochdale,41913,399,378,21
E08000005,Rochdale,15-19,393,820,-427
E08000005,Rochdale,20-24,1434,1145,289
E08000005,Rochdale,25-29,1183,1054,129
E08000005,Rochdale,30-34,988,857,131
E08000005,Rochdale,35-39,665,636,29
E08000005,Rochdale,40-44,481,411,70
E08000005,Rochdale,45-49,423,427,-4
E08000005,Rochdale,50-54,372,387,-15
E08000005,Rochdale,55-59,262,263,-1
E08000005,Rochdale,60-64,158,220,-62
E08000005,Rochdale,65-69,127,172,-45
E08000005,Rochdale,70-74,110,133,-23
E08000005,Rochdale,75-79,65,73,-8
E08000005,Rochdale,80-84,58,53,5
E08000005,Rochdale,85-89,30,55,-25
E08000005,Rochdale,90+,25,34,-9
E07000075,Rochford,0-4,352,228,124
E07000075,Rochford,05-Sep,296,128,168
E07000075,Rochford,41913,188,128,60
E07000075,Rochford,15-19,181,367,-186
E07000075,Rochford,20-24,636,463,173
E07000075,Rochford,25-29,549,533,16
E07000075,Rochford,30-34,539,352,187
E07000075,Rochford,35-39,410,277,133
E07000075,Rochford,40-44,277,194,83
E07000075,Rochford,45-49,251,200,51
E07000075,Rochford,50-54,243,234,9
E07000075,Rochford,55-59,197,198,-1
E07000075,Rochford,60-64,176,149,27
E07000075,Rochford,65-69,147,120,27
E07000075,Rochford,70-74,145,99,46
E07000075,Rochford,75-79,56,68,-12
E07000075,Rochford,80-84,63,77,-14
E07000075,Rochford,85-89,54,63,-9
E07000075,Rochford,90+,40,55,-15
E07000125,Rossendale,0-4,279,237,42
E07000125,Rossendale,05-Sep,214,166,48
E07000125,Rossendale,41913,161,123,38
E07000125,Rossendale,15-19,159,361,-202
E07000125,Rossendale,20-24,509,393,116
E07000125,Rossendale,25-29,490,387,103
E07000125,Rossendale,30-34,404,327,77
E07000125,Rossendale,35-39,263,227,36
E07000125,Rossendale,40-44,224,167,57
E07000125,Rossendale,45-49,203,178,25
E07000125,Rossendale,50-54,222,149,73
E07000125,Rossendale,55-59,152,153,-1
E07000125,Rossendale,60-64,108,126,-18
E07000125,Rossendale,65-69,75,99,-24
E07000125,Rossendale,70-74,59,89,-30
E07000125,Rossendale,75-79,45,56,-11
E07000125,Rossendale,80-84,26,26,0
E07000125,Rossendale,85-89,26,20,6
E07000125,Rossendale,90+,22,11,11
E07000064,Rother,0-4,288,255,33
E07000064,Rother,05-Sep,287,185,102
E07000064,Rother,41913,260,204,56
E07000064,Rother,15-19,259,480,-221
E07000064,Rother,20-24,680,649,31
E07000064,Rother,25-29,470,472,-2
E07000064,Rother,30-34,475,377,98
E07000064,Rother,35-39,373,273,100
E07000064,Rother,40-44,341,232,109
E07000064,Rother,45-49,308,249,59
E07000064,Rother,50-54,354,264,90
E07000064,Rother,55-59,433,273,160
E07000064,Rother,60-64,398,219,179
E07000064,Rother,65-69,298,219,79
E07000064,Rother,70-74,284,224,60
E07000064,Rother,75-79,150,124,26
E07000064,Rother,80-84,142,118,24
E07000064,Rother,85-89,98,122,-24
E07000064,Rother,90+,80,78,2
E08000018,Rotherham,0-4,702,598,104
E08000018,Rotherham,05-Sep,518,445,73
E08000018,Rotherham,41913,410,376,34
E08000018,Rotherham,15-19,503,964,-461
E08000018,Rotherham,20-24,1794,1356,438
E08000018,Rotherham,25-29,1370,1168,202
E08000018,Rotherham,30-34,1057,874,183
E08000018,Rotherham,35-39,717,637,80
E08000018,Rotherham,40-44,458,435,23
E08000018,Rotherham,45-49,498,463,35
E08000018,Rotherham,50-54,421,430,-9
E08000018,Rotherham,55-59,287,297,-10
E08000018,Rotherham,60-64,179,218,-39
E08000018,Rotherham,65-69,167,182,-15
E08000018,Rotherham,70-74,112,146,-34
E08000018,Rotherham,75-79,73,74,-1
E08000018,Rotherham,80-84,38,52,-14
E08000018,Rotherham,85-89,57,38,19
E08000018,Rotherham,90+,48,34,14
E07000220,Rugby,0-4,405,259,146
E07000220,Rugby,05-Sep,260,221,39
E07000220,Rugby,41913,325,180,145
E07000220,Rugby,15-19,219,688,-469
E07000220,Rugby,20-24,846,643,203
E07000220,Rugby,25-29,759,613,146
E07000220,Rugby,30-34,637,539,98
E07000220,Rugby,35-39,422,400,22
E07000220,Rugby,40-44,336,262,74
E07000220,Rugby,45-49,281,251,30
E07000220,Rugby,50-54,240,256,-16
E07000220,Rugby,55-59,175,203,-28
E07000220,Rugby,60-64,112,169,-57
E07000220,Rugby,65-69,87,122,-35
E07000220,Rugby,70-74,61,77,-16
E07000220,Rugby,75-79,42,49,-7
E07000220,Rugby,80-84,51,28,23
E07000220,Rugby,85-89,43,33,10
E07000220,Rugby,90+,46,32,14
E07000212,Runnymede,0-4,393,364,29
E07000212,Runnymede,05-Sep,218,227,-9
E07000212,Runnymede,41913,180,197,-17
E07000212,Runnymede,15-19,1410,513,897
E07000212,Runnymede,20-24,1798,2364,-566
E07000212,Runnymede,25-29,748,839,-91
E07000212,Runnymede,30-34,757,670,87
E07000212,Runnymede,35-39,529,520,9
E07000212,Runnymede,40-44,387,368,19
E07000212,Runnymede,45-49,259,316,-57
E07000212,Runnymede,50-54,264,264,0
E07000212,Runnymede,55-59,195,252,-57
E07000212,Runnymede,60-64,111,175,-64
E07000212,Runnymede,65-69,96,140,-44
E07000212,Runnymede,70-74,70,118,-48
E07000212,Runnymede,75-79,53,60,-7
E07000212,Runnymede,80-84,75,68,7
E07000212,Runnymede,85-89,50,63,-13
E07000212,Runnymede,90+,53,91,-38
E07000176,Rushcliffe,0-4,538,248,290
E07000176,Rushcliffe,05-Sep,350,174,176
E07000176,Rushcliffe,41913,226,133,93
E07000176,Rushcliffe,15-19,358,800,-442
E07000176,Rushcliffe,20-24,2234,1838,396
E07000176,Rushcliffe,25-29,1148,1032,116
E07000176,Rushcliffe,30-34,933,606,327
E07000176,Rushcliffe,35-39,690,443,247
E07000176,Rushcliffe,40-44,483,288,195
E07000176,Rushcliffe,45-49,361,334,27
E07000176,Rushcliffe,50-54,298,278,20
E07000176,Rushcliffe,55-59,220,253,-33
E07000176,Rushcliffe,60-64,172,213,-41
E07000176,Rushcliffe,65-69,179,129,50
E07000176,Rushcliffe,70-74,137,104,33
E07000176,Rushcliffe,75-79,85,68,17
E07000176,Rushcliffe,80-84,79,74,5
E07000176,Rushcliffe,85-89,71,62,9
E07000176,Rushcliffe,90+,57,62,-5
E07000092,Rushmoor,0-4,532,692,-160
E07000092,Rushmoor,05-Sep,317,510,-193
E07000092,Rushmoor,41913,181,328,-147
E07000092,Rushmoor,15-19,225,483,-258
E07000092,Rushmoor,20-24,956,836,120
E07000092,Rushmoor,25-29,971,893,78
E07000092,Rushmoor,30-34,802,836,-34
E07000092,Rushmoor,35-39,539,685,-146
E07000092,Rushmoor,40-44,310,429,-119
E07000092,Rushmoor,45-49,244,348,-104
E07000092,Rushmoor,50-54,204,315,-111
E07000092,Rushmoor,55-59,153,251,-98
E07000092,Rushmoor,60-64,107,167,-60
E07000092,Rushmoor,65-69,105,158,-53
E07000092,Rushmoor,70-74,56,92,-36
E07000092,Rushmoor,75-79,53,67,-14
E07000092,Rushmoor,80-84,52,38,14
E07000092,Rushmoor,85-89,57,38,19
E07000092,Rushmoor,90+,56,42,14
E06000017,Rutland,0-4,168,103,65
E06000017,Rutland,05-Sep,138,107,31
E06000017,Rutland,41913,293,111,182
E06000017,Rutland,15-19,166,511,-345
E06000017,Rutland,20-24,325,345,-20
E06000017,Rutland,25-29,255,263,-8
E06000017,Rutland,30-34,196,156,40
E06000017,Rutland,35-39,193,135,58
E06000017,Rutland,40-44,142,123,19
E06000017,Rutland,45-49,156,119,37
E06000017,Rutland,50-54,146,134,12
E06000017,Rutland,55-59,172,120,52
E06000017,Rutland,60-64,121,113,8
E06000017,Rutland,65-69,124,84,40
E06000017,Rutland,70-74,78,72,6
E06000017,Rutland,75-79,64,45,19
E06000017,Rutland,80-84,38,38,0
E06000017,Rutland,85-89,32,31,1
E06000017,Rutland,90+,17,14,3
E07000167,Ryedale,0-4,160,91,69
E07000167,Ryedale,05-Sep,132,68,64
E07000167,Ryedale,41913,156,73,83
E07000167,Ryedale,15-19,134,330,-196
E07000167,Ryedale,20-24,492,395,97
E07000167,Ryedale,25-29,306,298,8
E07000167,Ryedale,30-34,265,183,82
E07000167,Ryedale,35-39,250,124,126
E07000167,Ryedale,40-44,170,87,83
E07000167,Ryedale,45-49,215,119,96
E07000167,Ryedale,50-54,207,138,69
E07000167,Ryedale,55-59,229,132,97
E07000167,Ryedale,60-64,173,99,74
E07000167,Ryedale,65-69,130,113,17
E07000167,Ryedale,70-74,85,93,-8
E07000167,Ryedale,75-79,46,59,-13
E07000167,Ryedale,80-84,33,47,-14
E07000167,Ryedale,85-89,31,45,-14
E07000167,Ryedale,90+,21,36,-15
E08000006,Salford,0-4,832,1049,-217
E08000006,Salford,05-Sep,506,612,-106
E08000006,Salford,41913,348,391,-43
E08000006,Salford,15-19,1661,878,783
E08000006,Salford,20-24,4548,3528,1020
E08000006,Salford,25-29,3717,3165,552
E08000006,Salford,30-34,2271,2283,-12
E08000006,Salford,35-39,1262,1446,-184
E08000006,Salford,40-44,739,808,-69
E08000006,Salford,45-49,500,653,-153
E08000006,Salford,50-54,443,464,-21
E08000006,Salford,55-59,287,380,-93
E08000006,Salford,60-64,215,253,-38
E08000006,Salford,65-69,126,188,-62
E08000006,Salford,70-74,78,160,-82
E08000006,Salford,75-79,53,80,-27
E08000006,Salford,80-84,42,67,-25
E08000006,Salford,85-89,41,77,-36
E08000006,Salford,90+,29,36,-7
E08000028,Sandwell,0-4,1487,1532,-45
E08000028,Sandwell,05-Sep,977,1077,-100
E08000028,Sandwell,41913,708,820,-112
E08000028,Sandwell,15-19,678,1267,-589
E08000028,Sandwell,20-24,2218,1966,252
E08000028,Sandwell,25-29,2256,2238,18
E08000028,Sandwell,30-34,1906,2001,-95
E08000028,Sandwell,35-39,1453,1561,-108
E08000028,Sandwell,40-44,904,1057,-153
E08000028,Sandwell,45-49,847,888,-41
E08000028,Sandwell,50-54,608,756,-148
E08000028,Sandwell,55-59,457,479,-22
E08000028,Sandwell,60-64,275,392,-117
E08000028,Sandwell,65-69,178,245,-67
E08000028,Sandwell,70-74,114,163,-49
E08000028,Sandwell,75-79,102,133,-31
E08000028,Sandwell,80-84,92,113,-21
E08000028,Sandwell,85-89,85,117,-32
E08000028,Sandwell,90+,64,92,-28
E07000168,Scarborough,0-4,236,190,46
E07000168,Scarborough,05-Sep,200,159,41
E07000168,Scarborough,41913,149,137,12
E07000168,Scarborough,15-19,179,395,-216
E07000168,Scarborough,20-24,792,688,104
E07000168,Scarborough,25-29,433,525,-92
E07000168,Scarborough,30-34,307,363,-56
E07000168,Scarborough,35-39,270,272,-2
E07000168,Scarborough,40-44,239,232,7
E07000168,Scarborough,45-49,318,212,106
E07000168,Scarborough,50-54,361,197,164
E07000168,Scarborough,55-59,374,213,161
E07000168,Scarborough,60-64,328,174,154
E07000168,Scarborough,65-69,263,127,136
E07000168,Scarborough,70-74,179,136,43
E07000168,Scarborough,75-79,115,84,31
E07000168,Scarborough,80-84,72,63,9
E07000168,Scarborough,85-89,47,61,-14
E07000168,Scarborough,90+,42,49,-7
E07000188,Sedgemoor,0-4,343,312,31
E07000188,Sedgemoor,05-Sep,284,223,61
E07000188,Sedgemoor,41913,240,216,24
E07000188,Sedgemoor,15-19,221,567,-346
E07000188,Sedgemoor,20-24,841,740,101
E07000188,Sedgemoor,25-29,636,605,31
E07000188,Sedgemoor,30-34,558,440,118
E07000188,Sedgemoor,35-39,394,320,74
E07000188,Sedgemoor,40-44,318,266,52
E07000188,Sedgemoor,45-49,326,290,36
E07000188,Sedgemoor,50-54,364,300,64
E07000188,Sedgemoor,55-59,375,244,131
E07000188,Sedgemoor,60-64,305,227,78
E07000188,Sedgemoor,65-69,238,171,67
E07000188,Sedgemoor,70-74,160,192,-32
E07000188,Sedgemoor,75-79,93,97,-4
E07000188,Sedgemoor,80-84,82,88,-6
E07000188,Sedgemoor,85-89,84,51,33
E07000188,Sedgemoor,90+,53,60,-7
E08000014,Sefton,0-4,753,577,176
E08000014,Sefton,05-Sep,505,392,113
E08000014,Sefton,41913,432,292,140
E08000014,Sefton,15-19,384,1021,-637
E08000014,Sefton,20-24,1793,1451,342
E08000014,Sefton,25-29,1281,1311,-30
E08000014,Sefton,30-34,1058,964,94
E08000014,Sefton,35-39,907,661,246
E08000014,Sefton,40-44,618,425,193
E08000014,Sefton,45-49,559,446,113
E08000014,Sefton,50-54,526,355,171
E08000014,Sefton,55-59,456,389,67
E08000014,Sefton,60-64,366,279,87
E08000014,Sefton,65-69,288,189,99
E08000014,Sefton,70-74,268,163,105
E08000014,Sefton,75-79,130,99,31
E08000014,Sefton,80-84,117,115,2
E08000014,Sefton,85-89,83,115,-32
E08000014,Sefton,90+,52,71,-19
E07000169,Selby,0-4,413,246,167
E07000169,Selby,05-Sep,227,195,32
E07000169,Selby,41913,191,180,11
E07000169,Selby,15-19,210,510,-300
E07000169,Selby,20-24,821,532,289
E07000169,Selby,25-29,713,548,165
E07000169,Selby,30-34,583,407,176
E07000169,Selby,35-39,413,303,110
E07000169,Selby,40-44,316,251,65
E07000169,Selby,45-49,333,222,111
E07000169,Selby,50-54,281,238,43
E07000169,Selby,55-59,265,257,8
E07000169,Selby,60-64,191,179,12
E07000169,Selby,65-69,164,129,35
E07000169,Selby,70-74,116,111,5
E07000169,Selby,75-79,67,48,19
E07000169,Selby,80-84,59,53,6
E07000169,Selby,85-89,44,27,17
E07000169,Selby,90+,30,23,7
E07000111,Sevenoaks,0-4,613,409,204
E07000111,Sevenoaks,05-Sep,384,284,100
E07000111,Sevenoaks,41913,333,264,69
E07000111,Sevenoaks,15-19,277,811,-534
E07000111,Sevenoaks,20-24,1014,736,278
E07000111,Sevenoaks,25-29,873,862,11
E07000111,Sevenoaks,30-34,881,656,225
E07000111,Sevenoaks,35-39,719,492,227
E07000111,Sevenoaks,40-44,429,358,71
E07000111,Sevenoaks,45-49,383,348,35
E07000111,Sevenoaks,50-54,332,364,-32
E07000111,Sevenoaks,55-59,251,316,-65
E07000111,Sevenoaks,60-64,185,203,-18
E07000111,Sevenoaks,65-69,139,177,-38
E07000111,Sevenoaks,70-74,135,138,-3
E07000111,Sevenoaks,75-79,82,98,-16
E07000111,Sevenoaks,80-84,92,85,7
E07000111,Sevenoaks,85-89,110,109,1
E07000111,Sevenoaks,90+,94,93,1
E08000019,Sheffield,0-4,1105,1096,9
E08000019,Sheffield,05-Sep,678,713,-35
E08000019,Sheffield,41913,483,558,-75
E08000019,Sheffield,15-19,7169,1684,5485
E08000019,Sheffield,20-24,9350,12863,-3513
E08000019,Sheffield,25-29,3781,4885,-1104
E08000019,Sheffield,30-34,2222,2600,-378
E08000019,Sheffield,35-39,1500,1618,-118
E08000019,Sheffield,40-44,937,1027,-90
E08000019,Sheffield,45-49,698,979,-281
E08000019,Sheffield,50-54,643,756,-113
E08000019,Sheffield,55-59,456,624,-168
E08000019,Sheffield,60-64,327,441,-114
E08000019,Sheffield,65-69,248,319,-71
E08000019,Sheffield,70-74,174,235,-61
E08000019,Sheffield,75-79,112,111,1
E08000019,Sheffield,80-84,80,119,-39
E08000019,Sheffield,85-89,72,106,-34
E08000019,Sheffield,90+,55,70,-15
E06000051,Shropshire,0-4,802,514,288
E06000051,Shropshire,05-Sep,644,423,221
E06000051,Shropshire,41913,680,365,315
E06000051,Shropshire,15-19,735,1614,-879
E06000051,Shropshire,20-24,2156,1968,188
E06000051,Shropshire,25-29,1584,1482,102
E06000051,Shropshire,30-34,1125,924,201
E06000051,Shropshire,35-39,941,602,339
E06000051,Shropshire,40-44,759,498,261
E06000051,Shropshire,45-49,876,516,360
E06000051,Shropshire,50-54,886,559,327
E06000051,Shropshire,55-59,877,451,426
E06000051,Shropshire,60-64,802,373,429
E06000051,Shropshire,65-69,635,372,263
E06000051,Shropshire,70-74,433,296,137
E06000051,Shropshire,75-79,284,179,105
E06000051,Shropshire,80-84,212,124,88
E06000051,Shropshire,85-89,144,98,46
E06000051,Shropshire,90+,136,81,55
E06000039,Slough,0-4,777,872,-95
E06000039,Slough,05-Sep,526,677,-151
E06000039,Slough,41913,333,450,-117
E06000039,Slough,15-19,240,762,-522
E06000039,Slough,20-24,1068,965,103
E06000039,Slough,25-29,997,1090,-93
E06000039,Slough,30-34,1111,1264,-153
E06000039,Slough,35-39,893,1019,-126
E06000039,Slough,40-44,551,643,-92
E06000039,Slough,45-49,322,502,-180
E06000039,Slough,50-54,199,369,-170
E06000039,Slough,55-59,167,288,-121
E06000039,Slough,60-64,112,222,-110
E06000039,Slough,65-69,62,158,-96
E06000039,Slough,70-74,33,81,-48
E06000039,Slough,75-79,37,51,-14
E06000039,Slough,80-84,20,48,-28
E06000039,Slough,85-89,22,43,-21
E06000039,Slough,90+,12,28,-16
E08000029,Solihull,0-4,1013,677,336
E08000029,Solihull,05-Sep,649,484,165
E08000029,Solihull,41913,463,356,107
E08000029,Solihull,15-19,374,1179,-805
E08000029,Solihull,20-24,2001,1501,500
E08000029,Solihull,25-29,1566,1445,121
E08000029,Solihull,30-34,1382,1098,284
E08000029,Solihull,35-39,1055,888,167
E08000029,Solihull,40-44,671,534,137
E08000029,Solihull,45-49,499,524,-25
E08000029,Solihull,50-54,439,507,-68
E08000029,Solihull,55-59,344,451,-107
E08000029,Solihull,60-64,249,357,-108
E08000029,Solihull,65-69,215,245,-30
E08000029,Solihull,70-74,178,218,-40
E08000029,Solihull,75-79,131,128,3
E08000029,Solihull,80-84,125,112,13
E08000029,Solihull,85-89,98,139,-41
E08000029,Solihull,90+,83,132,-49
E07000006,South Bucks,0-4,348,319,29
E07000006,South Bucks,05-Sep,261,245,16
E07000006,South Bucks,41913,207,233,-26
E07000006,South Bucks,15-19,188,527,-339
E07000006,South Bucks,20-24,844,615,229
E07000006,South Bucks,25-29,602,621,-19
E07000006,South Bucks,30-34,609,533,76
E07000006,South Bucks,35-39,527,345,182
E07000006,South Bucks,40-44,355,307,48
E07000006,South Bucks,45-49,263,278,-15
E07000006,South Bucks,50-54,239,228,11
E07000006,South Bucks,55-59,200,201,-1
E07000006,South Bucks,60-64,126,186,-60
E07000006,South Bucks,65-69,106,138,-32
E07000006,South Bucks,70-74,79,114,-35
E07000006,South Bucks,75-79,57,71,-14
E07000006,South Bucks,80-84,80,59,21
E07000006,South Bucks,85-89,48,71,-23
E07000006,South Bucks,90+,53,52,1
E07000012,South Cambridgeshire,0-4,674,470,204
E07000012,South Cambridgeshire,05-Sep,496,386,110
E07000012,South Cambridgeshire,41913,371,306,65
E07000012,South Cambridgeshire,15-19,393,953,-560
E07000012,South Cambridgeshire,20-24,1797,1809,-12
E07000012,South Cambridgeshire,25-29,1648,1521,127
E07000012,South Cambridgeshire,30-34,1381,1169,212
E07000012,South Cambridgeshire,35-39,1108,870,238
E07000012,South Cambridgeshire,40-44,740,576,164
E07000012,South Cambridgeshire,45-49,532,512,20
E07000012,South Cambridgeshire,50-54,402,464,-62
E07000012,South Cambridgeshire,55-59,288,438,-150
E07000012,South Cambridgeshire,60-64,220,339,-119
E07000012,South Cambridgeshire,65-69,162,197,-35
E07000012,South Cambridgeshire,70-74,147,179,-32
E07000012,South Cambridgeshire,75-79,84,84,0
E07000012,South Cambridgeshire,80-84,91,121,-30
E07000012,South Cambridgeshire,85-89,95,99,-4
E07000012,South Cambridgeshire,90+,71,91,-20
E07000039,South Derbyshire,0-4,491,406,85
E07000039,South Derbyshire,05-Sep,405,253,152
E07000039,South Derbyshire,41913,344,232,112
E07000039,South Derbyshire,15-19,370,641,-271
E07000039,South Derbyshire,20-24,1034,751,283
E07000039,South Derbyshire,25-29,1025,676,349
E07000039,South Derbyshire,30-34,836,574,262
E07000039,South Derbyshire,35-39,600,392,208
E07000039,South Derbyshire,40-44,406,263,143
E07000039,South Derbyshire,45-49,418,318,100
E07000039,South Derbyshire,50-54,369,292,77
E07000039,South Derbyshire,55-59,337,219,118
E07000039,South Derbyshire,60-64,223,189,34
E07000039,South Derbyshire,65-69,182,167,15
E07000039,South Derbyshire,70-74,150,111,39
E07000039,South Derbyshire,75-79,100,57,43
E07000039,South Derbyshire,80-84,89,65,24
E07000039,South Derbyshire,85-89,100,46,54
E07000039,South Derbyshire,90+,82,30,52
E06000025,South Gloucestershire,0-4,964,774,190
E06000025,South Gloucestershire,05-Sep,580,483,97
E06000025,South Gloucestershire,41913,412,388,24
E06000025,South Gloucestershire,15-19,1705,1138,567
E06000025,South Gloucestershire,20-24,4144,3935,209
E06000025,South Gloucestershire,25-29,2608,2076,532
E06000025,South Gloucestershire,30-34,1981,1498,483
E06000025,South Gloucestershire,35-39,1389,1082,307
E06000025,South Gloucestershire,40-44,821,743,78
E06000025,South Gloucestershire,45-49,591,630,-39
E06000025,South Gloucestershire,50-54,517,614,-97
E06000025,South Gloucestershire,55-59,420,549,-129
E06000025,South Gloucestershire,60-64,296,378,-82
E06000025,South Gloucestershire,65-69,216,308,-92
E06000025,South Gloucestershire,70-74,180,181,-1
E06000025,South Gloucestershire,75-79,145,125,20
E06000025,South Gloucestershire,80-84,118,111,7
E06000025,South Gloucestershire,85-89,101,117,-16
E06000025,South Gloucestershire,90+,91,81,10
E07000044,South Hams,0-4,356,193,163
E07000044,South Hams,05-Sep,341,210,131
E07000044,South Hams,41913,253,139,114
E07000044,South Hams,15-19,222,461,-239
E07000044,South Hams,20-24,724,767,-43
E07000044,South Hams,25-29,609,535,74
E07000044,South Hams,30-34,491,397,94
E07000044,South Hams,35-39,436,286,150
E07000044,South Hams,40-44,380,231,149
E07000044,South Hams,45-49,369,277,92
E07000044,South Hams,50-54,403,290,113
E07000044,South Hams,55-59,414,283,131
E07000044,South Hams,60-64,346,240,106
E07000044,South Hams,65-69,279,211,68
E07000044,South Hams,70-74,203,166,37
E07000044,South Hams,75-79,85,109,-24
E07000044,South Hams,80-84,65,96,-31
E07000044,South Hams,85-89,57,84,-27
E07000044,South Hams,90+,51,68,-17
E07000140,South Holland,0-4,295,203,92
E07000140,South Holland,05-Sep,212,162,50
E07000140,South Holland,41913,197,123,74
E07000140,South Holland,15-19,203,462,-259
E07000140,South Holland,20-24,620,535,85
E07000140,South Holland,25-29,504,501,3
E07000140,South Holland,30-34,382,314,68
E07000140,South Holland,35-39,290,207,83
E07000140,South Holland,40-44,235,191,44
E07000140,South Holland,45-49,250,205,45
E07000140,South Holland,50-54,278,220,58
E07000140,South Holland,55-59,250,160,90
E07000140,South Holland,60-64,210,130,80
E07000140,South Holland,65-69,211,135,76
E07000140,South Holland,70-74,176,137,39
E07000140,South Holland,75-79,73,90,-17
E07000140,South Holland,80-84,51,61,-10
E07000140,South Holland,85-89,47,58,-11
E07000140,South Holland,90+,27,33,-6
E07000141,South Kesteven,0-4,479,324,155
E07000141,South Kesteven,05-Sep,349,265,84
E07000141,South Kesteven,41913,335,251,84
E07000141,South Kesteven,15-19,316,963,-647
E07000141,South Kesteven,20-24,1169,1048,121
E07000141,South Kesteven,25-29,863,805,58
E07000141,South Kesteven,30-34,637,582,55
E07000141,South Kesteven,35-39,546,414,132
E07000141,South Kesteven,40-44,405,307,98
E07000141,South Kesteven,45-49,429,384,45
E07000141,South Kesteven,50-54,413,365,48
E07000141,South Kesteven,55-59,446,338,108
E07000141,South Kesteven,60-64,286,245,41
E07000141,South Kesteven,65-69,246,217,29
E07000141,South Kesteven,70-74,208,197,11
E07000141,South Kesteven,75-79,129,91,38
E07000141,South Kesteven,80-84,119,99,20
E07000141,South Kesteven,85-89,104,65,39
E07000141,South Kesteven,90+,77,39,38
E07000031,South Lakeland,0-4,208,147,61
E07000031,South Lakeland,05-Sep,179,110,69
E07000031,South Lakeland,41913,257,131,126
E07000031,South Lakeland,15-19,268,492,-224
E07000031,South Lakeland,20-24,891,775,116
E07000031,South Lakeland,25-29,603,604,-1
E07000031,South Lakeland,30-34,449,381,68
E07000031,South Lakeland,35-39,328,236,92
E07000031,South Lakeland,40-44,273,212,61
E07000031,South Lakeland,45-49,283,209,74
E07000031,South Lakeland,50-54,359,229,130
E07000031,South Lakeland,55-59,336,226,110
E07000031,South Lakeland,60-64,256,226,30
E07000031,South Lakeland,65-69,206,170,36
E07000031,South Lakeland,70-74,147,167,-20
E07000031,South Lakeland,75-79,96,116,-20
E07000031,South Lakeland,80-84,69,65,4
E07000031,South Lakeland,85-89,53,72,-19
E07000031,South Lakeland,90+,51,56,-5
E07000149,South Norfolk,0-4,646,300,346
E07000149,South Norfolk,05-Sep,453,258,195
E07000149,South Norfolk,41913,467,207,260
E07000149,South Norfolk,15-19,383,911,-528
E07000149,South Norfolk,20-24,1152,1055,97
E07000149,South Norfolk,25-29,1257,849,408
E07000149,South Norfolk,30-34,1034,634,400
E07000149,South Norfolk,35-39,803,397,406
E07000149,South Norfolk,40-44,604,358,246
E07000149,South Norfolk,45-49,558,358,200
E07000149,South Norfolk,50-54,528,401,127
E07000149,South Norfolk,55-59,380,359,21
E07000149,South Norfolk,60-64,390,234,156
E07000149,South Norfolk,65-69,335,228,107
E07000149,South Norfolk,70-74,243,218,25
E07000149,South Norfolk,75-79,162,130,32
E07000149,South Norfolk,80-84,131,96,35
E07000149,South Norfolk,85-89,113,107,6
E07000149,South Norfolk,90+,106,77,29
E07000155,South Northamptonshire,0-4,477,230,247
E07000155,South Northamptonshire,05-Sep,335,247,88
E07000155,South Northamptonshire,41913,278,230,48
E07000155,South Northamptonshire,15-19,246,617,-371
E07000155,South Northamptonshire,20-24,966,672,294
E07000155,South Northamptonshire,25-29,858,569,289
E07000155,South Northamptonshire,30-34,811,463,348
E07000155,South Northamptonshire,35-39,626,397,229
E07000155,South Northamptonshire,40-44,386,333,53
E07000155,South Northamptonshire,45-49,405,319,86
E07000155,South Northamptonshire,50-54,365,325,40
E07000155,South Northamptonshire,55-59,271,268,3
E07000155,South Northamptonshire,60-64,198,240,-42
E07000155,South Northamptonshire,65-69,154,148,6
E07000155,South Northamptonshire,70-74,144,107,37
E07000155,South Northamptonshire,75-79,77,65,12
E07000155,South Northamptonshire,80-84,80,53,27
E07000155,South Northamptonshire,85-89,47,67,-20
E07000155,South Northamptonshire,90+,33,60,-27
E07000179,South Oxfordshire,0-4,555,501,54
E07000179,South Oxfordshire,05-Sep,408,324,84
E07000179,South Oxfordshire,41913,315,281,34
E07000179,South Oxfordshire,15-19,428,861,-433
E07000179,South Oxfordshire,20-24,1465,1321,144
E07000179,South Oxfordshire,25-29,1171,1126,45
E07000179,South Oxfordshire,30-34,1140,937,203
E07000179,South Oxfordshire,35-39,832,667,165
E07000179,South Oxfordshire,40-44,571,469,102
E07000179,South Oxfordshire,45-49,508,383,125
E07000179,South Oxfordshire,50-54,412,395,17
E07000179,South Oxfordshire,55-59,298,390,-92
E07000179,South Oxfordshire,60-64,238,296,-58
E07000179,South Oxfordshire,65-69,179,216,-37
E07000179,South Oxfordshire,70-74,163,146,17
E07000179,South Oxfordshire,75-79,119,80,39
E07000179,South Oxfordshire,80-84,107,77,30
E07000179,South Oxfordshire,85-89,98,89,9
E07000179,South Oxfordshire,90+,84,60,24
E07000126,South Ribble,0-4,363,309,54
E07000126,South Ribble,05-Sep,274,240,34
E07000126,South Ribble,41913,197,184,13
E07000126,South Ribble,15-19,187,518,-331
E07000126,South Ribble,20-24,814,624,190
E07000126,South Ribble,25-29,786,628,158
E07000126,South Ribble,30-34,567,540,27
E07000126,South Ribble,35-39,430,415,15
E07000126,South Ribble,40-44,284,304,-20
E07000126,South Ribble,45-49,254,293,-39
E07000126,South Ribble,50-54,259,230,29
E07000126,South Ribble,55-59,197,200,-3
E07000126,South Ribble,60-64,153,153,0
E07000126,South Ribble,65-69,155,113,42
E07000126,South Ribble,70-74,119,110,9
E07000126,South Ribble,75-79,41,75,-34
E07000126,South Ribble,80-84,62,78,-16
E07000126,South Ribble,85-89,44,55,-11
E07000126,South Ribble,90+,41,58,-17
E07000189,South Somerset,0-4,474,385,89
E07000189,South Somerset,05-Sep,382,295,87
E07000189,South Somerset,41913,375,300,75
E07000189,South Somerset,15-19,368,761,-393
E07000189,South Somerset,20-24,1123,1123,0
E07000189,South Somerset,25-29,825,906,-81
E07000189,South Somerset,30-34,625,551,74
E07000189,South Somerset,35-39,533,410,123
E07000189,South Somerset,40-44,386,365,21
E07000189,South Somerset,45-49,444,394,50
E07000189,South Somerset,50-54,491,378,113
E07000189,South Somerset,55-59,476,326,150
E07000189,South Somerset,60-64,436,301,135
E07000189,South Somerset,65-69,422,281,141
E07000189,South Somerset,70-74,317,234,83
E07000189,South Somerset,75-79,178,170,8
E07000189,South Somerset,80-84,88,94,-6
E07000189,South Somerset,85-89,109,103,6
E07000189,South Somerset,90+,68,66,2
E07000196,South Staffordshire,0-4,417,264,153
E07000196,South Staffordshire,05-Sep,355,242,113
E07000196,South Staffordshire,41913,245,186,59
E07000196,South Staffordshire,15-19,221,563,-342
E07000196,South Staffordshire,20-24,843,764,79
E07000196,South Staffordshire,25-29,661,757,-96
E07000196,South Staffordshire,30-34,607,540,67
E07000196,South Staffordshire,35-39,439,331,108
E07000196,South Staffordshire,40-44,334,278,56
E07000196,South Staffordshire,45-49,312,326,-14
E07000196,South Staffordshire,50-54,334,320,14
E07000196,South Staffordshire,55-59,281,245,36
E07000196,South Staffordshire,60-64,196,180,16
E07000196,South Staffordshire,65-69,181,150,31
E07000196,South Staffordshire,70-74,165,102,63
E07000196,South Staffordshire,75-79,109,89,20
E07000196,South Staffordshire,80-84,121,81,40
E07000196,South Staffordshire,85-89,97,94,3
E07000196,South Staffordshire,90+,83,68,15
E08000023,South Tyneside,0-4,381,233,148
E08000023,South Tyneside,05-Sep,207,164,43
E08000023,South Tyneside,41913,189,132,57
E08000023,South Tyneside,15-19,195,368,-173
E08000023,South Tyneside,20-24,790,660,130
E08000023,South Tyneside,25-29,685,549,136
E08000023,South Tyneside,30-34,547,421,126
E08000023,South Tyneside,35-39,352,325,27
E08000023,South Tyneside,40-44,236,187,49
E08000023,South Tyneside,45-49,224,193,31
E08000023,South Tyneside,50-54,205,137,68
E08000023,South Tyneside,55-59,181,135,46
E08000023,South Tyneside,60-64,136,109,27
E08000023,South Tyneside,65-69,108,77,31
E08000023,South Tyneside,70-74,70,42,28
E08000023,South Tyneside,75-79,38,33,5
E08000023,South Tyneside,80-84,25,28,-3
E08000023,South Tyneside,85-89,8,33,-25
E08000023,South Tyneside,90+,7,26,-19
E06000045,Southampton,0-4,529,857,-328
E06000045,Southampton,05-Sep,354,573,-219
E06000045,Southampton,41913,222,374,-152
E06000045,Southampton,15-19,4183,761,3422
E06000045,Southampton,20-24,5221,7982,-2761
E06000045,Southampton,25-29,2345,3275,-930
E06000045,Southampton,30-34,1447,1986,-539
E06000045,Southampton,35-39,928,1403,-475
E06000045,Southampton,40-44,565,846,-281
E06000045,Southampton,45-49,504,601,-97
E06000045,Southampton,50-54,388,519,-131
E06000045,Southampton,55-59,321,373,-52
E06000045,Southampton,60-64,200,328,-128
E06000045,Southampton,65-69,137,204,-67
E06000045,Southampton,70-74,105,106,-1
E06000045,Southampton,75-79,78,82,-4
E06000045,Southampton,80-84,55,78,-23
E06000045,Southampton,85-89,60,91,-31
E06000045,Southampton,90+,70,84,-14
E06000033,Southend-on-Sea,0-4,630,596,34
E06000033,Southend-on-Sea,05-Sep,392,352,40
E06000033,Southend-on-Sea,41913,332,283,49
E06000033,Southend-on-Sea,15-19,356,852,-496
E06000033,Southend-on-Sea,20-24,1470,1164,306
E06000033,Southend-on-Sea,25-29,1095,1133,-38
E06000033,Southend-on-Sea,30-34,1014,884,130
E06000033,Southend-on-Sea,35-39,824,690,134
E06000033,Southend-on-Sea,40-44,509,462,47
E06000033,Southend-on-Sea,45-49,456,435,21
E06000033,Southend-on-Sea,50-54,443,426,17
E06000033,Southend-on-Sea,55-59,367,363,4
E06000033,Southend-on-Sea,60-64,243,254,-11
E06000033,Southend-on-Sea,65-69,204,211,-7
E06000033,Southend-on-Sea,70-74,182,154,28
E06000033,Southend-on-Sea,75-79,114,77,37
E06000033,Southend-on-Sea,80-84,97,65,32
E06000033,Southend-on-Sea,85-89,94,73,21
E06000033,Southend-on-Sea,90+,65,35,30
E09000028,Southwark,0-4,833,1860,-1027
E09000028,Southwark,05-Sep,476,939,-463
E09000028,Southwark,41913,347,681,-334
E09000028,Southwark,15-19,1708,1425,283
E09000028,Southwark,20-24,7821,6334,1487
E09000028,Southwark,25-29,7741,6473,1268
E09000028,Southwark,30-34,4788,5632,-844
E09000028,Southwark,35-39,2519,3669,-1150
E09000028,Southwark,40-44,1339,2131,-792
E09000028,Southwark,45-49,946,1345,-399
E09000028,Southwark,50-54,669,1018,-349
E09000028,Southwark,55-59,495,698,-203
E09000028,Southwark,60-64,255,422,-167
E09000028,Southwark,65-69,149,243,-94
E09000028,Southwark,70-74,74,161,-87
E09000028,Southwark,75-79,49,88,-39
E09000028,Southwark,80-84,46,72,-26
E09000028,Southwark,85-89,32,86,-54
E09000028,Southwark,90+,25,65,-40
E07000213,Spelthorne,0-4,481,482,-1
E07000213,Spelthorne,05-Sep,295,301,-6
E07000213,Spelthorne,41913,192,200,-8
E07000213,Spelthorne,15-19,181,417,-236
E07000213,Spelthorne,20-24,784,623,161
E07000213,Spelthorne,25-29,832,786,46
E07000213,Spelthorne,30-34,835,815,20
E07000213,Spelthorne,35-39,666,560,106
E07000213,Spelthorne,40-44,392,435,-43
E07000213,Spelthorne,45-49,317,306,11
E07000213,Spelthorne,50-54,256,315,-59
E07000213,Spelthorne,55-59,179,275,-96
E07000213,Spelthorne,60-64,142,188,-46
E07000213,Spelthorne,65-69,89,148,-59
E07000213,Spelthorne,70-74,82,125,-43
E07000213,Spelthorne,75-79,41,67,-26
E07000213,Spelthorne,80-84,45,70,-25
E07000213,Spelthorne,85-89,32,70,-38
E07000213,Spelthorne,90+,49,52,-3
E07000240,St Albans,0-4,662,498,164
E07000240,St Albans,05-Sep,336,322,14
E07000240,St Albans,41913,285,211,74
E07000240,St Albans,15-19,205,1181,-976
E07000240,St Albans,20-24,1698,1121,577
E07000240,St Albans,25-29,1206,1316,-110
E07000240,St Albans,30-34,1209,1137,72
E07000240,St Albans,35-39,961,830,131
E07000240,St Albans,40-44,587,513,74
E07000240,St Albans,45-49,383,437,-54
E07000240,St Albans,50-54,290,359,-69
E07000240,St Albans,55-59,191,334,-143
E07000240,St Albans,60-64,126,241,-115
E07000240,St Albans,65-69,100,180,-80
E07000240,St Albans,70-74,93,113,-20
E07000240,St Albans,75-79,69,84,-15
E07000240,St Albans,80-84,76,74,2
E07000240,St Albans,85-89,81,55,26
E07000240,St Albans,90+,57,54,3
E07000204,St Edmundsbury,0-4,324,383,-59
E07000204,St Edmundsbury,05-Sep,233,254,-21
E07000204,St Edmundsbury,41913,248,196,52
E07000204,St Edmundsbury,15-19,262,649,-387
E07000204,St Edmundsbury,20-24,816,756,60
E07000204,St Edmundsbury,25-29,688,736,-48
E07000204,St Edmundsbury,30-34,600,570,30
E07000204,St Edmundsbury,35-39,408,391,17
E07000204,St Edmundsbury,40-44,291,315,-24
E07000204,St Edmundsbury,45-49,323,277,46
E07000204,St Edmundsbury,50-54,311,298,13
E07000204,St Edmundsbury,55-59,245,225,20
E07000204,St Edmundsbury,60-64,184,173,11
E07000204,St Edmundsbury,65-69,159,158,1
E07000204,St Edmundsbury,70-74,154,140,14
E07000204,St Edmundsbury,75-79,90,80,10
E07000204,St Edmundsbury,80-84,83,65,18
E07000204,St Edmundsbury,85-89,66,61,5
E07000204,St Edmundsbury,90+,56,39,17
E08000013,St. Helens,0-4,464,369,95
E08000013,St. Helens,05-Sep,294,286,8
E08000013,St. Helens,41913,260,223,37
E08000013,St. Helens,15-19,244,583,-339
E08000013,St. Helens,20-24,1032,775,257
E08000013,St. Helens,25-29,1000,779,221
E08000013,St. Helens,30-34,784,628,156
E08000013,St. Helens,35-39,568,470,98
E08000013,St. Helens,40-44,351,272,79
E08000013,St. Helens,45-49,346,326,20
E08000013,St. Helens,50-54,313,296,17
E08000013,St. Helens,55-59,241,199,42
E08000013,St. Helens,60-64,172,143,29
E08000013,St. Helens,65-69,101,114,-13
E08000013,St. Helens,70-74,82,72,10
E08000013,St. Helens,75-79,36,63,-27
E08000013,St. Helens,80-84,45,43,2
E08000013,St. Helens,85-89,31,29,2
E08000013,St. Helens,90+,20,23,-3
E07000197,Stafford,0-4,467,319,148
E07000197,Stafford,05-Sep,367,217,150
E07000197,Stafford,41913,258,209,49
E07000197,Stafford,15-19,292,600,-308
E07000197,Stafford,20-24,1135,1015,120
E07000197,Stafford,25-29,891,776,115
E07000197,Stafford,30-34,685,516,169
E07000197,Stafford,35-39,532,365,167
E07000197,Stafford,40-44,399,291,108
E07000197,Stafford,45-49,380,301,79
E07000197,Stafford,50-54,361,278,83
E07000197,Stafford,55-59,253,210,43
E07000197,Stafford,60-64,186,195,-9
E07000197,Stafford,65-69,198,178,20
E07000197,Stafford,70-74,133,102,31
E07000197,Stafford,75-79,96,72,24
E07000197,Stafford,80-84,83,70,13
E07000197,Stafford,85-89,79,68,11
E07000197,Stafford,90+,65,53,12
E07000198,Staffordshire Moorlands,0-4,243,201,42
E07000198,Staffordshire Moorlands,05-Sep,229,176,53
E07000198,Staffordshire Moorlands,41913,235,175,60
E07000198,Staffordshire Moorlands,15-19,173,438,-265
E07000198,Staffordshire Moorlands,20-24,607,530,77
E07000198,Staffordshire Moorlands,25-29,483,482,1
E07000198,Staffordshire Moorlands,30-34,407,361,46
E07000198,Staffordshire Moorlands,35-39,308,254,54
E07000198,Staffordshire Moorlands,40-44,234,219,15
E07000198,Staffordshire Moorlands,45-49,239,203,36
E07000198,Staffordshire Moorlands,50-54,230,179,51
E07000198,Staffordshire Moorlands,55-59,210,163,47
E07000198,Staffordshire Moorlands,60-64,154,140,14
E07000198,Staffordshire Moorlands,65-69,107,111,-4
E07000198,Staffordshire Moorlands,70-74,95,109,-14
E07000198,Staffordshire Moorlands,75-79,62,52,10
E07000198,Staffordshire Moorlands,80-84,48,52,-4
E07000198,Staffordshire Moorlands,85-89,45,66,-21
E07000198,Staffordshire Moorlands,90+,34,36,-2
E07000243,Stevenage,0-4,301,327,-26
E07000243,Stevenage,05-Sep,179,250,-71
E07000243,Stevenage,41913,147,206,-59
E07000243,Stevenage,15-19,140,455,-315
E07000243,Stevenage,20-24,868,651,217
E07000243,Stevenage,25-29,758,671,87
E07000243,Stevenage,30-34,642,618,24
E07000243,Stevenage,35-39,468,441,27
E07000243,Stevenage,40-44,250,317,-67
E07000243,Stevenage,45-49,221,292,-71
E07000243,Stevenage,50-54,195,245,-50
E07000243,Stevenage,55-59,112,208,-96
E07000243,Stevenage,60-64,87,134,-47
E07000243,Stevenage,65-69,45,112,-67
E07000243,Stevenage,70-74,57,93,-36
E07000243,Stevenage,75-79,41,47,-6
E07000243,Stevenage,80-84,56,32,24
E07000243,Stevenage,85-89,47,42,5
E07000243,Stevenage,90+,39,28,11
E08000007,Stockport,0-4,897,811,86
E08000007,Stockport,05-Sep,547,470,77
E08000007,Stockport,41913,401,388,13
E08000007,Stockport,15-19,372,1381,-1009
E08000007,Stockport,20-24,2215,1735,480
E08000007,Stockport,25-29,2048,1696,352
E08000007,Stockport,30-34,1848,1356,492
E08000007,Stockport,35-39,1321,971,350
E08000007,Stockport,40-44,809,581,228
E08000007,Stockport,45-49,567,603,-36
E08000007,Stockport,50-54,420,584,-164
E08000007,Stockport,55-59,319,490,-171
E08000007,Stockport,60-64,245,403,-158
E08000007,Stockport,65-69,190,305,-115
E08000007,Stockport,70-74,181,210,-29
E08000007,Stockport,75-79,125,138,-13
E08000007,Stockport,80-84,84,135,-51
E08000007,Stockport,85-89,89,123,-34
E08000007,Stockport,90+,58,114,-56
E06000004,Stockton-on-Tees,0-4,530,447,83
E06000004,Stockton-on-Tees,05-Sep,427,328,99
E06000004,Stockton-on-Tees,41913,279,250,29
E06000004,Stockton-on-Tees,15-19,445,814,-369
E06000004,Stockton-on-Tees,20-24,1295,1901,-606
E06000004,Stockton-on-Tees,25-29,1059,1069,-10
E06000004,Stockton-on-Tees,30-34,821,719,102
E06000004,Stockton-on-Tees,35-39,553,517,36
E06000004,Stockton-on-Tees,40-44,398,382,16
E06000004,Stockton-on-Tees,45-49,390,311,79
E06000004,Stockton-on-Tees,50-54,302,278,24
E06000004,Stockton-on-Tees,55-59,244,236,8
E06000004,Stockton-on-Tees,60-64,178,156,22
E06000004,Stockton-on-Tees,65-69,138,128,10
E06000004,Stockton-on-Tees,70-74,93,77,16
E06000004,Stockton-on-Tees,75-79,45,52,-7
E06000004,Stockton-on-Tees,80-84,53,41,12
E06000004,Stockton-on-Tees,85-89,43,38,5
E06000004,Stockton-on-Tees,90+,30,18,12
E06000021,Stoke-on-Trent,0-4,612,845,-233
E06000021,Stoke-on-Trent,05-Sep,468,568,-100
E06000021,Stoke-on-Trent,41913,349,497,-148
E06000021,Stoke-on-Trent,15-19,1180,734,446
E06000021,Stoke-on-Trent,20-24,2540,2563,-23
E06000021,Stoke-on-Trent,25-29,1422,1627,-205
E06000021,Stoke-on-Trent,30-34,997,1235,-238
E06000021,Stoke-on-Trent,35-39,698,864,-166
E06000021,Stoke-on-Trent,40-44,499,669,-170
E06000021,Stoke-on-Trent,45-49,435,579,-144
E06000021,Stoke-on-Trent,50-54,320,458,-138
E06000021,Stoke-on-Trent,55-59,333,302,31
E06000021,Stoke-on-Trent,60-64,199,224,-25
E06000021,Stoke-on-Trent,65-69,144,186,-42
E06000021,Stoke-on-Trent,70-74,90,129,-39
E06000021,Stoke-on-Trent,75-79,66,99,-33
E06000021,Stoke-on-Trent,80-84,62,88,-26
E06000021,Stoke-on-Trent,85-89,78,87,-9
E06000021,Stoke-on-Trent,90+,68,59,9
E07000221,Stratford-on-Avon,0-4,567,290,277
E07000221,Stratford-on-Avon,05-Sep,400,200,200
E07000221,Stratford-on-Avon,41913,334,187,147
E07000221,Stratford-on-Avon,15-19,351,743,-392
E07000221,Stratford-on-Avon,20-24,1340,1004,336
E07000221,Stratford-on-Avon,25-29,950,786,164
E07000221,Stratford-on-Avon,30-34,881,582,299
E07000221,Stratford-on-Avon,35-39,680,386,294
E07000221,Stratford-on-Avon,40-44,482,314,168
E07000221,Stratford-on-Avon,45-49,502,304,198
E07000221,Stratford-on-Avon,50-54,480,318,162
E07000221,Stratford-on-Avon,55-59,414,317,97
E07000221,Stratford-on-Avon,60-64,405,223,182
E07000221,Stratford-on-Avon,65-69,323,242,81
E07000221,Stratford-on-Avon,70-74,271,193,78
E07000221,Stratford-on-Avon,75-79,143,95,48
E07000221,Stratford-on-Avon,80-84,140,91,49
E07000221,Stratford-on-Avon,85-89,111,77,34
E07000221,Stratford-on-Avon,90+,89,67,22
E07000082,Stroud,0-4,390,246,144
E07000082,Stroud,05-Sep,362,190,172
E07000082,Stroud,41913,259,171,88
E07000082,Stroud,15-19,273,679,-406
E07000082,Stroud,20-24,1024,912,112
E07000082,Stroud,25-29,726,748,-22
E07000082,Stroud,30-34,632,491,141
E07000082,Stroud,35-39,578,342,236
E07000082,Stroud,40-44,400,273,127
E07000082,Stroud,45-49,359,281,78
E07000082,Stroud,50-54,350,292,58
E07000082,Stroud,55-59,300,231,69
E07000082,Stroud,60-64,241,214,27
E07000082,Stroud,65-69,190,150,40
E07000082,Stroud,70-74,119,132,-13
E07000082,Stroud,75-79,72,60,12
E07000082,Stroud,80-84,67,62,5
E07000082,Stroud,85-89,85,62,23
E07000082,Stroud,90+,65,33,32
E07000205,Suffolk Coastal,0-4,425,216,209
E07000205,Suffolk Coastal,05-Sep,349,192,157
E07000205,Suffolk Coastal,41913,300,186,114
E07000205,Suffolk Coastal,15-19,246,823,-577
E07000205,Suffolk Coastal,20-24,991,939,52
E07000205,Suffolk Coastal,25-29,676,640,36
E07000205,Suffolk Coastal,30-34,637,477,160
E07000205,Suffolk Coastal,35-39,464,287,177
E07000205,Suffolk Coastal,40-44,400,227,173
E07000205,Suffolk Coastal,45-49,418,284,134
E07000205,Suffolk Coastal,50-54,351,263,88
E07000205,Suffolk Coastal,55-59,360,267,93
E07000205,Suffolk Coastal,60-64,396,198,198
E07000205,Suffolk Coastal,65-69,314,177,137
E07000205,Suffolk Coastal,70-74,228,166,62
E07000205,Suffolk Coastal,75-79,139,114,25
E07000205,Suffolk Coastal,80-84,100,81,19
E07000205,Suffolk Coastal,85-89,115,66,49
E07000205,Suffolk Coastal,90+,81,52,29
E08000024,Sunderland,0-4,528,427,101
E08000024,Sunderland,05-Sep,345,314,31
E08000024,Sunderland,41913,279,271,8
E08000024,Sunderland,15-19,501,676,-175
E08000024,Sunderland,20-24,1506,1790,-284
E08000024,Sunderland,25-29,1038,1261,-223
E08000024,Sunderland,30-34,795,841,-46
E08000024,Sunderland,35-39,577,614,-37
E08000024,Sunderland,40-44,368,354,14
E08000024,Sunderland,45-49,363,390,-27
E08000024,Sunderland,50-54,283,352,-69
E08000024,Sunderland,55-59,260,238,22
E08000024,Sunderland,60-64,193,178,15
E08000024,Sunderland,65-69,149,154,-5
E08000024,Sunderland,70-74,83,91,-8
E08000024,Sunderland,75-79,64,67,-3
E08000024,Sunderland,80-84,33,55,-22
E08000024,Sunderland,85-89,32,41,-9
E08000024,Sunderland,90+,24,29,-5
E07000214,Surrey Heath,0-4,402,348,54
E07000214,Surrey Heath,05-Sep,321,231,90
E07000214,Surrey Heath,41913,227,242,-15
E07000214,Surrey Heath,15-19,195,642,-447
E07000214,Surrey Heath,20-24,1047,727,320
E07000214,Surrey Heath,25-29,755,832,-77
E07000214,Surrey Heath,30-34,674,633,41
E07000214,Surrey Heath,35-39,555,443,112
E07000214,Surrey Heath,40-44,425,338,87
E07000214,Surrey Heath,45-49,292,312,-20
E07000214,Surrey Heath,50-54,245,300,-55
E07000214,Surrey Heath,55-59,209,276,-67
E07000214,Surrey Heath,60-64,139,216,-77
E07000214,Surrey Heath,65-69,86,175,-89
E07000214,Surrey Heath,70-74,97,95,2
E07000214,Surrey Heath,75-79,69,71,-2
E07000214,Surrey Heath,80-84,77,72,5
E07000214,Surrey Heath,85-89,106,52,54
E07000214,Surrey Heath,90+,80,43,37
E09000029,Sutton,0-4,971,935,36
E09000029,Sutton,05-Sep,671,600,71
E09000029,Sutton,41913,480,486,-6
E09000029,Sutton,15-19,343,1134,-791
E09000029,Sutton,20-24,1857,1394,463
E09000029,Sutton,25-29,1718,1608,110
E09000029,Sutton,30-34,1813,1499,314
E09000029,Sutton,35-39,1513,1131,382
E09000029,Sutton,40-44,942,839,103
E09000029,Sutton,45-49,536,644,-108
E09000029,Sutton,50-54,384,607,-223
E09000029,Sutton,55-59,288,478,-190
E09000029,Sutton,60-64,217,364,-147
E09000029,Sutton,65-69,189,257,-68
E09000029,Sutton,70-74,120,191,-71
E09000029,Sutton,75-79,86,97,-11
E09000029,Sutton,80-84,74,89,-15
E09000029,Sutton,85-89,44,82,-38
E09000029,Sutton,90+,57,61,-4
E07000113,Swale,0-4,481,364,117
E07000113,Swale,05-Sep,363,295,68
E07000113,Swale,41913,277,221,56
E07000113,Swale,15-19,248,614,-366
E07000113,Swale,20-24,917,727,190
E07000113,Swale,25-29,823,647,176
E07000113,Swale,30-34,685,521,164
E07000113,Swale,35-39,550,397,153
E07000113,Swale,40-44,389,278,111
E07000113,Swale,45-49,374,292,82
E07000113,Swale,50-54,424,292,132
E07000113,Swale,55-59,291,244,47
E07000113,Swale,60-64,218,201,17
E07000113,Swale,65-69,182,180,2
E07000113,Swale,70-74,132,130,2
E07000113,Swale,75-79,62,96,-34
E07000113,Swale,80-84,51,57,-6
E07000113,Swale,85-89,39,58,-19
E07000113,Swale,90+,45,44,1
E06000030,Swindon,0-4,547,576,-29
E06000030,Swindon,05-Sep,358,488,-130
E06000030,Swindon,41913,215,312,-97
E06000030,Swindon,15-19,290,792,-502
E06000030,Swindon,20-24,1557,1172,385
E06000030,Swindon,25-29,1349,1094,255
E06000030,Swindon,30-34,1069,916,153
E06000030,Swindon,35-39,760,758,2
E06000030,Swindon,40-44,482,531,-49
E06000030,Swindon,45-49,437,447,-10
E06000030,Swindon,50-54,358,426,-68
E06000030,Swindon,55-59,269,375,-106
E06000030,Swindon,60-64,216,288,-72
E06000030,Swindon,65-69,158,153,5
E06000030,Swindon,70-74,120,115,5
E06000030,Swindon,75-79,79,55,24
E06000030,Swindon,80-84,49,43,6
E06000030,Swindon,85-89,55,46,9
E06000030,Swindon,90+,38,27,11
E08000008,Tameside,0-4,624,644,-20
E08000008,Tameside,05-Sep,482,411,71
E08000008,Tameside,41913,361,322,39
E08000008,Tameside,15-19,381,787,-406
E08000008,Tameside,20-24,1414,976,438
E08000008,Tameside,25-29,1333,1128,205
E08000008,Tameside,30-34,1067,929,138
E08000008,Tameside,35-39,802,629,173
E08000008,Tameside,40-44,476,458,18
E08000008,Tameside,45-49,487,504,-17
E08000008,Tameside,50-54,372,366,6
E08000008,Tameside,55-59,269,340,-71
E08000008,Tameside,60-64,186,273,-87
E08000008,Tameside,65-69,148,189,-41
E08000008,Tameside,70-74,128,121,7
E08000008,Tameside,75-79,79,79,0
E08000008,Tameside,80-84,83,55,28
E08000008,Tameside,85-89,59,30,29
E08000008,Tameside,90+,42,39,3
E07000199,Tamworth,0-4,263,238,25
E07000199,Tamworth,05-Sep,180,191,-11
E07000199,Tamworth,41913,120,148,-28
E07000199,Tamworth,15-19,125,300,-175
E07000199,Tamworth,20-24,501,416,85
E07000199,Tamworth,25-29,455,437,18
E07000199,Tamworth,30-34,399,364,35
E07000199,Tamworth,35-39,237,257,-20
E07000199,Tamworth,40-44,168,201,-33
E07000199,Tamworth,45-49,154,214,-60
E07000199,Tamworth,50-54,145,171,-26
E07000199,Tamworth,55-59,139,139,0
E07000199,Tamworth,60-64,96,100,-4
E07000199,Tamworth,65-69,78,85,-7
E07000199,Tamworth,70-74,63,60,3
E07000199,Tamworth,75-79,37,36,1
E07000199,Tamworth,80-84,37,27,10
E07000199,Tamworth,85-89,25,43,-18
E07000199,Tamworth,90+,19,18,1
E07000215,Tandridge,0-4,432,319,113
E07000215,Tandridge,05-Sep,263,229,34
E07000215,Tandridge,41913,222,221,1
E07000215,Tandridge,15-19,226,579,-353
E07000215,Tandridge,20-24,778,669,109
E07000215,Tandridge,25-29,660,751,-91
E07000215,Tandridge,30-34,668,536,132
E07000215,Tandridge,35-39,529,405,124
E07000215,Tandridge,40-44,321,281,40
E07000215,Tandridge,45-49,293,301,-8
E07000215,Tandridge,50-54,283,279,4
E07000215,Tandridge,55-59,214,296,-82
E07000215,Tandridge,60-64,130,212,-82
E07000215,Tandridge,65-69,112,166,-54
E07000215,Tandridge,70-74,111,119,-8
E07000215,Tandridge,75-79,61,76,-15
E07000215,Tandridge,80-84,57,70,-13
E07000215,Tandridge,85-89,86,48,38
E07000215,Tandridge,90+,64,46,18
E07000190,Taunton Deane,0-4,427,330,97
E07000190,Taunton Deane,05-Sep,300,220,80
E07000190,Taunton Deane,41913,259,176,83
E07000190,Taunton Deane,15-19,362,713,-351
E07000190,Taunton Deane,20-24,1033,833,200
E07000190,Taunton Deane,25-29,865,735,130
E07000190,Taunton Deane,30-34,601,544,57
E07000190,Taunton Deane,35-39,423,337,86
E07000190,Taunton Deane,40-44,387,277,110
E07000190,Taunton Deane,45-49,335,247,88
E07000190,Taunton Deane,50-54,394,263,131
E07000190,Taunton Deane,55-59,363,243,120
E07000190,Taunton Deane,60-64,283,203,80
E07000190,Taunton Deane,65-69,265,145,120
E07000190,Taunton Deane,70-74,191,122,69
E07000190,Taunton Deane,75-79,139,76,63
E07000190,Taunton Deane,80-84,101,60,41
E07000190,Taunton Deane,85-89,102,35,67
E07000190,Taunton Deane,90+,85,36,49
E07000045,Teignbridge,0-4,420,276,144
E07000045,Teignbridge,05-Sep,348,235,113
E07000045,Teignbridge,41913,245,245,0
E07000045,Teignbridge,15-19,281,559,-278
E07000045,Teignbridge,20-24,976,925,51
E07000045,Teignbridge,25-29,834,768,66
E07000045,Teignbridge,30-34,743,557,186
E07000045,Teignbridge,35-39,654,388,266
E07000045,Teignbridge,40-44,459,290,169
E07000045,Teignbridge,45-49,453,348,105
E07000045,Teignbridge,50-54,505,313,192
E07000045,Teignbridge,55-59,509,293,216
E07000045,Teignbridge,60-64,447,266,181
E07000045,Teignbridge,65-69,368,230,138
E07000045,Teignbridge,70-74,231,217,14
E07000045,Teignbridge,75-79,176,121,55
E07000045,Teignbridge,80-84,127,105,22
E07000045,Teignbridge,85-89,90,80,10
E07000045,Teignbridge,90+,95,48,47
E06000020,Telford and Wrekin,0-4,544,367,177
E06000020,Telford and Wrekin,05-Sep,409,254,155
E06000020,Telford and Wrekin,41913,315,221,94
E06000020,Telford and Wrekin,15-19,770,746,24
E06000020,Telford and Wrekin,20-24,1821,1901,-80
E06000020,Telford and Wrekin,25-29,967,928,39
E06000020,Telford and Wrekin,30-34,692,578,114
E06000020,Telford and Wrekin,35-39,566,408,158
E06000020,Telford and Wrekin,40-44,420,311,109
E06000020,Telford and Wrekin,45-49,397,327,70
E06000020,Telford and Wrekin,50-54,352,324,28
E06000020,Telford and Wrekin,55-59,272,238,34
E06000020,Telford and Wrekin,60-64,234,173,61
E06000020,Telford and Wrekin,65-69,176,135,41
E06000020,Telford and Wrekin,70-74,137,94,43
E06000020,Telford and Wrekin,75-79,81,84,-3
E06000020,Telford and Wrekin,80-84,56,57,-1
E06000020,Telford and Wrekin,85-89,30,47,-17
E06000020,Telford and Wrekin,90+,32,39,-7
E07000076,Tendring,0-4,490,264,226
E07000076,Tendring,05-Sep,428,277,151
E07000076,Tendring,41913,300,244,56
E07000076,Tendring,15-19,263,587,-324
E07000076,Tendring,20-24,803,710,93
E07000076,Tendring,25-29,653,583,70
E07000076,Tendring,30-34,555,429,126
E07000076,Tendring,35-39,432,304,128
E07000076,Tendring,40-44,374,230,144
E07000076,Tendring,45-49,392,279,113
E07000076,Tendring,50-54,471,268,203
E07000076,Tendring,55-59,509,250,259
E07000076,Tendring,60-64,478,212,266
E07000076,Tendring,65-69,435,186,249
E07000076,Tendring,70-74,337,167,170
E07000076,Tendring,75-79,145,124,21
E07000076,Tendring,80-84,104,123,-19
E07000076,Tendring,85-89,81,107,-26
E07000076,Tendring,90+,68,80,-12
E07000093,Test Valley,0-4,593,424,169
E07000093,Test Valley,05-Sep,415,296,119
E07000093,Test Valley,41913,287,286,1
E07000093,Test Valley,15-19,301,583,-282
E07000093,Test Valley,20-24,1065,913,152
E07000093,Test Valley,25-29,942,789,153
E07000093,Test Valley,30-34,790,603,187
E07000093,Test Valley,35-39,718,444,274
E07000093,Test Valley,40-44,478,341,137
E07000093,Test Valley,45-49,432,357,75
E07000093,Test Valley,50-54,379,336,43
E07000093,Test Valley,55-59,355,341,14
E07000093,Test Valley,60-64,227,222,5
E07000093,Test Valley,65-69,176,205,-29
E07000093,Test Valley,70-74,147,136,11
E07000093,Test Valley,75-79,86,80,6
E07000093,Test Valley,80-84,97,70,27
E07000093,Test Valley,85-89,79,87,-8
E07000093,Test Valley,90+,74,67,7
E07000083,Tewkesbury,0-4,554,327,227
E07000083,Tewkesbury,05-Sep,401,261,140
E07000083,Tewkesbury,41913,276,195,81
E07000083,Tewkesbury,15-19,262,506,-244
E07000083,Tewkesbury,20-24,881,627,254
E07000083,Tewkesbury,25-29,923,591,332
E07000083,Tewkesbury,30-34,752,478,274
E07000083,Tewkesbury,35-39,663,368,295
E07000083,Tewkesbury,40-44,366,256,110
E07000083,Tewkesbury,45-49,342,265,77
E07000083,Tewkesbury,50-54,358,276,82
E07000083,Tewkesbury,55-59,329,260,69
E07000083,Tewkesbury,60-64,253,191,62
E07000083,Tewkesbury,65-69,250,152,98
E07000083,Tewkesbury,70-74,175,131,44
E07000083,Tewkesbury,75-79,106,93,13
E07000083,Tewkesbury,80-84,71,73,-2
E07000083,Tewkesbury,85-89,48,73,-25
E07000083,Tewkesbury,90+,35,71,-36
E07000114,Thanet,0-4,344,319,25
E07000114,Thanet,05-Sep,248,254,-6
E07000114,Thanet,41913,253,215,38
E07000114,Thanet,15-19,221,593,-372
E07000114,Thanet,20-24,801,812,-11
E07000114,Thanet,25-29,556,598,-42
E07000114,Thanet,30-34,493,391,102
E07000114,Thanet,35-39,438,321,117
E07000114,Thanet,40-44,375,264,111
E07000114,Thanet,45-49,338,270,68
E07000114,Thanet,50-54,374,249,125
E07000114,Thanet,55-59,322,255,67
E07000114,Thanet,60-64,282,170,112
E07000114,Thanet,65-69,266,153,113
E07000114,Thanet,70-74,167,153,14
E07000114,Thanet,75-79,99,86,13
E07000114,Thanet,80-84,69,81,-12
E07000114,Thanet,85-89,52,90,-38
E07000114,Thanet,90+,20,64,-44
E07000102,Three Rivers,0-4,447,393,54
E07000102,Three Rivers,05-Sep,356,265,91
E07000102,Three Rivers,41913,288,223,65
E07000102,Three Rivers,15-19,208,663,-455
E07000102,Three Rivers,20-24,1065,705,360
E07000102,Three Rivers,25-29,750,780,-30
E07000102,Three Rivers,30-34,768,738,30
E07000102,Three Rivers,35-39,671,507,164
E07000102,Three Rivers,40-44,439,382,57
E07000102,Three Rivers,45-49,338,317,21
E07000102,Three Rivers,50-54,243,264,-21
E07000102,Three Rivers,55-59,196,281,-85
E07000102,Three Rivers,60-64,114,160,-46
E07000102,Three Rivers,65-69,107,169,-62
E07000102,Three Rivers,70-74,77,92,-15
E07000102,Three Rivers,75-79,61,65,-4
E07000102,Three Rivers,80-84,58,71,-13
E07000102,Three Rivers,85-89,41,82,-41
E07000102,Three Rivers,90+,69,44,25
E06000034,Thurrock,0-4,988,765,223
E06000034,Thurrock,05-Sep,636,576,60
E06000034,Thurrock,41913,389,415,-26
E06000034,Thurrock,15-19,395,721,-326
E06000034,Thurrock,20-24,1089,914,175
E06000034,Thurrock,25-29,1376,959,417
E06000034,Thurrock,30-34,1255,1015,240
E06000034,Thurrock,35-39,933,739,194
E06000034,Thurrock,40-44,554,579,-25
E06000034,Thurrock,45-49,461,475,-14
E06000034,Thurrock,50-54,344,440,-96
E06000034,Thurrock,55-59,272,298,-26
E06000034,Thurrock,60-64,170,262,-92
E06000034,Thurrock,65-69,94,212,-118
E06000034,Thurrock,70-74,87,128,-41
E06000034,Thurrock,75-79,56,57,-1
E06000034,Thurrock,80-84,45,51,-6
E06000034,Thurrock,85-89,45,52,-7
E06000034,Thurrock,90+,30,33,-3
E07000115,Tonbridge and Malling,0-4,617,378,239
E07000115,Tonbridge and Malling,05-Sep,430,290,140
E07000115,Tonbridge and Malling,41913,367,284,83
E07000115,Tonbridge and Malling,15-19,328,886,-558
E07000115,Tonbridge and Malling,20-24,1058,907,151
E07000115,Tonbridge and Malling,25-29,1060,826,234
E07000115,Tonbridge and Malling,30-34,897,701,196
E07000115,Tonbridge and Malling,35-39,794,500,294
E07000115,Tonbridge and Malling,40-44,548,364,184
E07000115,Tonbridge and Malling,45-49,398,371,27
E07000115,Tonbridge and Malling,50-54,390,386,4
E07000115,Tonbridge and Malling,55-59,322,285,37
E07000115,Tonbridge and Malling,60-64,228,215,13
E07000115,Tonbridge and Malling,65-69,174,145,29
E07000115,Tonbridge and Malling,70-74,172,173,-1
E07000115,Tonbridge and Malling,75-79,123,98,25
E07000115,Tonbridge and Malling,80-84,84,86,-2
E07000115,Tonbridge and Malling,85-89,85,92,-7
E07000115,Tonbridge and Malling,90+,71,90,-19
E06000027,Torbay,0-4,320,337,-17
E06000027,Torbay,05-Sep,311,260,51
E06000027,Torbay,41913,305,227,78
E06000027,Torbay,15-19,300,563,-263
E06000027,Torbay,20-24,874,926,-52
E06000027,Torbay,25-29,702,740,-38
E06000027,Torbay,30-34,542,512,30
E06000027,Torbay,35-39,424,391,33
E06000027,Torbay,40-44,397,302,95
E06000027,Torbay,45-49,455,290,165
E06000027,Torbay,50-54,446,357,89
E06000027,Torbay,55-59,505,333,172
E06000027,Torbay,60-64,472,267,205
E06000027,Torbay,65-69,366,255,111
E06000027,Torbay,70-74,269,203,66
E06000027,Torbay,75-79,166,128,38
E06000027,Torbay,80-84,100,108,-8
E06000027,Torbay,85-89,77,74,3
E06000027,Torbay,90+,60,42,18
E07000046,Torridge,0-4,219,176,43
E07000046,Torridge,05-Sep,222,180,42
E07000046,Torridge,41913,144,159,-15
E07000046,Torridge,15-19,186,383,-197
E07000046,Torridge,20-24,454,467,-13
E07000046,Torridge,25-29,377,354,23
E07000046,Torridge,30-34,272,229,43
E07000046,Torridge,35-39,255,216,39
E07000046,Torridge,40-44,213,187,26
E07000046,Torridge,45-49,268,229,39
E07000046,Torridge,50-54,342,198,144
E07000046,Torridge,55-59,341,196,145
E07000046,Torridge,60-64,288,178,110
E07000046,Torridge,65-69,245,162,83
E07000046,Torridge,70-74,151,184,-33
E07000046,Torridge,75-79,93,114,-21
E07000046,Torridge,80-84,75,75,0
E07000046,Torridge,85-89,76,48,28
E07000046,Torridge,90+,34,31,3
E09000030,Tower Hamlets,0-4,795,1558,-763
E09000030,Tower Hamlets,05-Sep,473,721,-248
E09000030,Tower Hamlets,41913,300,449,-149
E09000030,Tower Hamlets,15-19,1226,616,610
E09000030,Tower Hamlets,20-24,7006,5216,1790
E09000030,Tower Hamlets,25-29,7594,7054,540
E09000030,Tower Hamlets,30-34,4500,5966,-1466
E09000030,Tower Hamlets,35-39,2169,3432,-1263
E09000030,Tower Hamlets,40-44,1035,1508,-473
E09000030,Tower Hamlets,45-49,656,843,-187
E09000030,Tower Hamlets,50-54,478,582,-104
E09000030,Tower Hamlets,55-59,283,368,-85
E09000030,Tower Hamlets,60-64,191,267,-76
E09000030,Tower Hamlets,65-69,87,134,-47
E09000030,Tower Hamlets,70-74,58,109,-51
E09000030,Tower Hamlets,75-79,36,71,-35
E09000030,Tower Hamlets,80-84,22,70,-48
E09000030,Tower Hamlets,85-89,5,45,-40
E09000030,Tower Hamlets,90+,15,43,-28
E08000009,Trafford,0-4,908,663,245
E08000009,Trafford,05-Sep,620,430,190
E08000009,Trafford,41913,439,345,94
E08000009,Trafford,15-19,339,1350,-1011
E08000009,Trafford,20-24,2028,1711,317
E08000009,Trafford,25-29,1879,1703,176
E08000009,Trafford,30-34,1835,1438,397
E08000009,Trafford,35-39,1393,1021,372
E08000009,Trafford,40-44,782,630,152
E08000009,Trafford,45-49,484,531,-47
E08000009,Trafford,50-54,334,542,-208
E08000009,Trafford,55-59,262,415,-153
E08000009,Trafford,60-64,192,346,-154
E08000009,Trafford,65-69,115,271,-156
E08000009,Trafford,70-74,127,173,-46
E08000009,Trafford,75-79,87,108,-21
E08000009,Trafford,80-84,67,112,-45
E08000009,Trafford,85-89,69,96,-27
E08000009,Trafford,90+,43,86,-43
E07000116,Tunbridge Wells,0-4,431,367,64
E07000116,Tunbridge Wells,05-Sep,297,242,55
E07000116,Tunbridge Wells,41913,371,261,110
E07000116,Tunbridge Wells,15-19,246,957,-711
E07000116,Tunbridge Wells,20-24,1164,964,200
E07000116,Tunbridge Wells,25-29,835,862,-27
E07000116,Tunbridge Wells,30-34,720,705,15
E07000116,Tunbridge Wells,35-39,620,490,130
E07000116,Tunbridge Wells,40-44,399,335,64
E07000116,Tunbridge Wells,45-49,342,310,32
E07000116,Tunbridge Wells,50-54,308,367,-59
E07000116,Tunbridge Wells,55-59,248,317,-69
E07000116,Tunbridge Wells,60-64,211,228,-17
E07000116,Tunbridge Wells,65-69,134,165,-31
E07000116,Tunbridge Wells,70-74,127,131,-4
E07000116,Tunbridge Wells,75-79,80,98,-18
E07000116,Tunbridge Wells,80-84,94,74,20
E07000116,Tunbridge Wells,85-89,105,84,21
E07000116,Tunbridge Wells,90+,89,46,43
E07000077,Uttlesford,0-4,488,265,223
E07000077,Uttlesford,05-Sep,348,209,139
E07000077,Uttlesford,41913,264,238,26
E07000077,Uttlesford,15-19,229,712,-483
E07000077,Uttlesford,20-24,856,665,191
E07000077,Uttlesford,25-29,743,576,167
E07000077,Uttlesford,30-34,683,433,250
E07000077,Uttlesford,35-39,591,327,264
E07000077,Uttlesford,40-44,410,230,180
E07000077,Uttlesford,45-49,323,254,69
E07000077,Uttlesford,50-54,338,288,50
E07000077,Uttlesford,55-59,263,266,-3
E07000077,Uttlesford,60-64,194,167,27
E07000077,Uttlesford,65-69,141,124,17
E07000077,Uttlesford,70-74,102,118,-16
E07000077,Uttlesford,75-79,58,52,6
E07000077,Uttlesford,80-84,55,50,5
E07000077,Uttlesford,85-89,57,30,27
E07000077,Uttlesford,90+,55,29,26
E07000180,Vale of White Horse,0-4,747,498,249
E07000180,Vale of White Horse,05-Sep,484,354,130
E07000180,Vale of White Horse,41913,433,297,136
E07000180,Vale of White Horse,15-19,408,791,-383
E07000180,Vale of White Horse,20-24,1703,1342,361
E07000180,Vale of White Horse,25-29,1417,1114,303
E07000180,Vale of White Horse,30-34,1204,860,344
E07000180,Vale of White Horse,35-39,948,633,315
E07000180,Vale of White Horse,40-44,612,349,263
E07000180,Vale of White Horse,45-49,446,338,108
E07000180,Vale of White Horse,50-54,363,343,20
E07000180,Vale of White Horse,55-59,298,291,7
E07000180,Vale of White Horse,60-64,246,249,-3
E07000180,Vale of White Horse,65-69,162,167,-5
E07000180,Vale of White Horse,70-74,143,119,24
E07000180,Vale of White Horse,75-79,80,74,6
E07000180,Vale of White Horse,80-84,102,83,19
E07000180,Vale of White Horse,85-89,79,74,5
E07000180,Vale of White Horse,90+,56,60,-4
E08000036,Wakefield,0-4,993,615,378
E08000036,Wakefield,05-Sep,665,448,217
E08000036,Wakefield,41913,475,364,111
E08000036,Wakefield,15-19,515,1262,-747
E08000036,Wakefield,20-24,2412,1612,800
E08000036,Wakefield,25-29,1983,1341,642
E08000036,Wakefield,30-34,1651,1082,569
E08000036,Wakefield,35-39,1095,724,371
E08000036,Wakefield,40-44,738,533,205
E08000036,Wakefield,45-49,734,554,180
E08000036,Wakefield,50-54,563,515,48
E08000036,Wakefield,55-59,472,399,73
E08000036,Wakefield,60-64,345,286,59
E08000036,Wakefield,65-69,241,198,43
E08000036,Wakefield,70-74,173,168,5
E08000036,Wakefield,75-79,116,79,37
E08000036,Wakefield,80-84,89,82,7
E08000036,Wakefield,85-89,73,72,1
E08000036,Wakefield,90+,49,51,-2
E08000030,Walsall,0-4,1206,1008,198
E08000030,Walsall,05-Sep,788,690,98
E08000030,Walsall,41913,636,517,119
E08000030,Walsall,15-19,630,1061,-431
E08000030,Walsall,20-24,2009,1685,324
E08000030,Walsall,25-29,1775,1629,146
E08000030,Walsall,30-34,1411,1316,95
E08000030,Walsall,35-39,1087,987,100
E08000030,Walsall,40-44,751,636,115
E08000030,Walsall,45-49,601,596,5
E08000030,Walsall,50-54,533,495,38
E08000030,Walsall,55-59,366,424,-58
E08000030,Walsall,60-64,280,305,-25
E08000030,Walsall,65-69,160,232,-72
E08000030,Walsall,70-74,110,172,-62
E08000030,Walsall,75-79,88,96,-8
E08000030,Walsall,80-84,73,116,-43
E08000030,Walsall,85-89,67,108,-41
E08000030,Walsall,90+,59,107,-48
E09000031,Waltham Forest,0-4,1231,2152,-921
E09000031,Waltham Forest,05-Sep,682,1400,-718
E09000031,Waltham Forest,41913,474,986,-512
E09000031,Waltham Forest,15-19,554,1250,-696
E09000031,Waltham Forest,20-24,2685,2318,367
E09000031,Waltham Forest,25-29,3360,3624,-264
E09000031,Waltham Forest,30-34,3809,3658,151
E09000031,Waltham Forest,35-39,2397,2717,-320
E09000031,Waltham Forest,40-44,1245,1689,-444
E09000031,Waltham Forest,45-49,735,1143,-408
E09000031,Waltham Forest,50-54,511,868,-357
E09000031,Waltham Forest,55-59,339,713,-374
E09000031,Waltham Forest,60-64,227,457,-230
E09000031,Waltham Forest,65-69,151,324,-173
E09000031,Waltham Forest,70-74,84,187,-103
E09000031,Waltham Forest,75-79,62,122,-60
E09000031,Waltham Forest,80-84,51,102,-51
E09000031,Waltham Forest,85-89,37,71,-34
E09000031,Waltham Forest,90+,31,69,-38
E09000032,Wandsworth,0-4,1082,2283,-1201
E09000032,Wandsworth,05-Sep,514,1057,-543
E09000032,Wandsworth,41913,351,821,-470
E09000032,Wandsworth,15-19,1347,1360,-13
E09000032,Wandsworth,20-24,8582,4875,3707
E09000032,Wandsworth,25-29,10987,8545,2442
E09000032,Wandsworth,30-34,6000,7820,-1820
E09000032,Wandsworth,35-39,3107,4840,-1733
E09000032,Wandsworth,40-44,1535,2428,-893
E09000032,Wandsworth,45-49,977,1352,-375
E09000032,Wandsworth,50-54,705,871,-166
E09000032,Wandsworth,55-59,556,623,-67
E09000032,Wandsworth,60-64,274,446,-172
E09000032,Wandsworth,65-69,168,294,-126
E09000032,Wandsworth,70-74,161,228,-67
E09000032,Wandsworth,75-79,79,128,-49
E09000032,Wandsworth,80-84,81,105,-24
E09000032,Wandsworth,85-89,48,68,-20
E09000032,Wandsworth,90+,48,76,-28
E06000007,Warrington,0-4,467,441,26
E06000007,Warrington,05-Sep,276,309,-33
E06000007,Warrington,41913,234,236,-2
E06000007,Warrington,15-19,303,990,-687
E06000007,Warrington,20-24,1643,1393,250
E06000007,Warrington,25-29,1093,1053,40
E06000007,Warrington,30-34,874,848,26
E06000007,Warrington,35-39,659,640,19
E06000007,Warrington,40-44,417,406,11
E06000007,Warrington,45-49,372,413,-41
E06000007,Warrington,50-54,370,389,-19
E06000007,Warrington,55-59,224,357,-133
E06000007,Warrington,60-64,187,210,-23
E06000007,Warrington,65-69,128,132,-4
E06000007,Warrington,70-74,110,110,0
E06000007,Warrington,75-79,85,61,24
E06000007,Warrington,80-84,80,58,22
E06000007,Warrington,85-89,69,42,27
E06000007,Warrington,90+,42,30,12
E07000222,Warwick,0-4,424,347,77
E07000222,Warwick,05-Sep,289,202,87
E07000222,Warwick,41913,203,177,26
E07000222,Warwick,15-19,648,722,-74
E07000222,Warwick,20-24,4488,3218,1270
E07000222,Warwick,25-29,1437,1419,18
E07000222,Warwick,30-34,1101,997,104
E07000222,Warwick,35-39,693,661,32
E07000222,Warwick,40-44,448,409,39
E07000222,Warwick,45-49,371,403,-32
E07000222,Warwick,50-54,331,322,9
E07000222,Warwick,55-59,256,272,-16
E07000222,Warwick,60-64,168,178,-10
E07000222,Warwick,65-69,144,154,-10
E07000222,Warwick,70-74,102,106,-4
E07000222,Warwick,75-79,75,76,-1
E07000222,Warwick,80-84,80,67,13
E07000222,Warwick,85-89,81,75,6
E07000222,Warwick,90+,73,51,22
E07000103,Watford,0-4,497,619,-122
E07000103,Watford,05-Sep,312,425,-113
E07000103,Watford,41913,209,290,-81
E07000103,Watford,15-19,197,525,-328
E07000103,Watford,20-24,1185,831,354
E07000103,Watford,25-29,1085,1015,70
E07000103,Watford,30-34,1060,1066,-6
E07000103,Watford,35-39,652,812,-160
E07000103,Watford,40-44,442,593,-151
E07000103,Watford,45-49,326,398,-72
E07000103,Watford,50-54,207,293,-86
E07000103,Watford,55-59,154,249,-95
E07000103,Watford,60-64,102,184,-82
E07000103,Watford,65-69,75,124,-49
E07000103,Watford,70-74,60,79,-19
E07000103,Watford,75-79,51,55,-4
E07000103,Watford,80-84,57,48,9
E07000103,Watford,85-89,66,36,30
E07000103,Watford,90+,73,38,35
E07000206,Waveney,0-4,326,273,53
E07000206,Waveney,05-Sep,274,190,84
E07000206,Waveney,41913,254,190,64
E07000206,Waveney,15-19,201,442,-241
E07000206,Waveney,20-24,677,649,28
E07000206,Waveney,25-29,494,538,-44
E07000206,Waveney,30-34,410,360,50
E07000206,Waveney,35-39,314,265,49
E07000206,Waveney,40-44,255,205,50
E07000206,Waveney,45-49,306,229,77
E07000206,Waveney,50-54,362,234,128
E07000206,Waveney,55-59,335,186,149
E07000206,Waveney,60-64,286,138,148
E07000206,Waveney,65-69,295,163,132
E07000206,Waveney,70-74,208,124,84
E07000206,Waveney,75-79,101,71,30
E07000206,Waveney,80-84,88,90,-2
E07000206,Waveney,85-89,65,70,-5
E07000206,Waveney,90+,46,39,7
E07000216,Waverley,0-4,573,391,182
E07000216,Waverley,05-Sep,339,292,47
E07000216,Waverley,41913,493,275,218
E07000216,Waverley,15-19,727,1194,-467
E07000216,Waverley,20-24,1415,1492,-77
E07000216,Waverley,25-29,891,1035,-144
E07000216,Waverley,30-34,965,802,163
E07000216,Waverley,35-39,745,540,205
E07000216,Waverley,40-44,534,433,101
E07000216,Waverley,45-49,388,426,-38
E07000216,Waverley,50-54,357,379,-22
E07000216,Waverley,55-59,291,319,-28
E07000216,Waverley,60-64,221,276,-55
E07000216,Waverley,65-69,185,168,17
E07000216,Waverley,70-74,149,156,-7
E07000216,Waverley,75-79,109,95,14
E07000216,Waverley,80-84,122,97,25
E07000216,Waverley,85-89,102,91,11
E07000216,Waverley,90+,111,103,8
E07000065,Wealden,0-4,638,315,323
E07000065,Wealden,05-Sep,437,292,145
E07000065,Wealden,41913,390,294,96
E07000065,Wealden,15-19,353,896,-543
E07000065,Wealden,20-24,1167,1032,135
E07000065,Wealden,25-29,894,869,25
E07000065,Wealden,30-34,831,557,274
E07000065,Wealden,35-39,657,423,234
E07000065,Wealden,40-44,532,347,185
E07000065,Wealden,45-49,506,397,109
E07000065,Wealden,50-54,614,394,220
E07000065,Wealden,55-59,470,373,97
E07000065,Wealden,60-64,416,294,122
E07000065,Wealden,65-69,346,254,92
E07000065,Wealden,70-74,299,263,36
E07000065,Wealden,75-79,155,188,-33
E07000065,Wealden,80-84,142,166,-24
E07000065,Wealden,85-89,130,137,-7
E07000065,Wealden,90+,119,128,-9
E07000156,Wellingborough,0-4,315,315,0
E07000156,Wellingborough,05-Sep,221,232,-11
E07000156,Wellingborough,41913,197,179,18
E07000156,Wellingborough,15-19,164,435,-271
E07000156,Wellingborough,20-24,648,480,168
E07000156,Wellingborough,25-29,538,523,15
E07000156,Wellingborough,30-34,528,394,134
E07000156,Wellingborough,35-39,371,329,42
E07000156,Wellingborough,40-44,264,248,16
E07000156,Wellingborough,45-49,242,264,-22
E07000156,Wellingborough,50-54,235,236,-1
E07000156,Wellingborough,55-59,186,163,23
E07000156,Wellingborough,60-64,143,123,20
E07000156,Wellingborough,65-69,93,112,-19
E07000156,Wellingborough,70-74,102,73,29
E07000156,Wellingborough,75-79,73,59,14
E07000156,Wellingborough,80-84,57,43,14
E07000156,Wellingborough,85-89,65,39,26
E07000156,Wellingborough,90+,42,44,-2
E07000241,Welwyn Hatfield,0-4,477,471,6
E07000241,Welwyn Hatfield,05-Sep,335,306,29
E07000241,Welwyn Hatfield,41913,240,232,8
E07000241,Welwyn Hatfield,15-19,1623,686,937
E07000241,Welwyn Hatfield,20-24,2749,4016,-1267
E07000241,Welwyn Hatfield,25-29,1073,1381,-308
E07000241,Welwyn Hatfield,30-34,898,893,5
E07000241,Welwyn Hatfield,35-39,692,644,48
E07000241,Welwyn Hatfield,40-44,425,400,25
E07000241,Welwyn Hatfield,45-49,318,337,-19
E07000241,Welwyn Hatfield,50-54,265,319,-54
E07000241,Welwyn Hatfield,55-59,198,285,-87
E07000241,Welwyn Hatfield,60-64,131,202,-71
E07000241,Welwyn Hatfield,65-69,99,150,-51
E07000241,Welwyn Hatfield,70-74,91,78,13
E07000241,Welwyn Hatfield,75-79,70,60,10
E07000241,Welwyn Hatfield,80-84,78,65,13
E07000241,Welwyn Hatfield,85-89,67,61,6
E07000241,Welwyn Hatfield,90+,45,47,-2
E06000037,West Berkshire,0-4,535,471,64
E06000037,West Berkshire,05-Sep,413,382,31
E06000037,West Berkshire,41913,500,378,122
E06000037,West Berkshire,15-19,330,1140,-810
E06000037,West Berkshire,20-24,1411,1138,273
E06000037,West Berkshire,25-29,1059,1122,-63
E06000037,West Berkshire,30-34,939,837,102
E06000037,West Berkshire,35-39,733,662,71
E06000037,West Berkshire,40-44,441,446,-5
E06000037,West Berkshire,45-49,410,441,-31
E06000037,West Berkshire,50-54,365,398,-33
E06000037,West Berkshire,55-59,315,351,-36
E06000037,West Berkshire,60-64,203,305,-102
E06000037,West Berkshire,65-69,153,235,-82
E06000037,West Berkshire,70-74,138,155,-17
E06000037,West Berkshire,75-79,85,94,-9
E06000037,West Berkshire,80-84,74,95,-21
E06000037,West Berkshire,85-89,71,61,10
E06000037,West Berkshire,90+,55,62,-7
E07000047,West Devon,0-4,195,199,-4
E07000047,West Devon,05-Sep,181,146,35
E07000047,West Devon,41913,143,123,20
E07000047,West Devon,15-19,177,368,-191
E07000047,West Devon,20-24,454,470,-16
E07000047,West Devon,25-29,323,318,5
E07000047,West Devon,30-34,240,257,-17
E07000047,West Devon,35-39,297,208,89
E07000047,West Devon,40-44,185,131,54
E07000047,West Devon,45-49,212,184,28
E07000047,West Devon,50-54,263,202,61
E07000047,West Devon,55-59,257,163,94
E07000047,West Devon,60-64,259,138,121
E07000047,West Devon,65-69,163,142,21
E07000047,West Devon,70-74,138,124,14
E07000047,West Devon,75-79,54,74,-20
E07000047,West Devon,80-84,54,62,-8
E07000047,West Devon,85-89,48,56,-8
E07000047,West Devon,90+,37,26,11
E07000052,West Dorset,0-4,331,265,66
E07000052,West Dorset,05-Sep,300,206,94
E07000052,West Dorset,41913,364,222,142
E07000052,West Dorset,15-19,254,861,-607
E07000052,West Dorset,20-24,834,862,-28
E07000052,West Dorset,25-29,629,644,-15
E07000052,West Dorset,30-34,551,486,65
E07000052,West Dorset,35-39,443,324,119
E07000052,West Dorset,40-44,381,244,137
E07000052,West Dorset,45-49,424,285,139
E07000052,West Dorset,50-54,434,283,151
E07000052,West Dorset,55-59,493,289,204
E07000052,West Dorset,60-64,481,241,240
E07000052,West Dorset,65-69,411,238,173
E07000052,West Dorset,70-74,256,194,62
E07000052,West Dorset,75-79,206,94,112
E07000052,West Dorset,80-84,145,101,44
E07000052,West Dorset,85-89,126,96,30
E07000052,West Dorset,90+,91,69,22
E07000127,West Lancashire,0-4,331,204,127
E07000127,West Lancashire,05-Sep,273,174,99
E07000127,West Lancashire,41913,189,152,37
E07000127,West Lancashire,15-19,1399,621,778
E07000127,West Lancashire,20-24,1550,2520,-970
E07000127,West Lancashire,25-29,527,715,-188
E07000127,West Lancashire,30-34,424,450,-26
E07000127,West Lancashire,35-39,352,294,58
E07000127,West Lancashire,40-44,241,226,15
E07000127,West Lancashire,45-49,290,261,29
E07000127,West Lancashire,50-54,287,242,45
E07000127,West Lancashire,55-59,241,172,69
E07000127,West Lancashire,60-64,168,178,-10
E07000127,West Lancashire,65-69,132,184,-52
E07000127,West Lancashire,70-74,112,121,-9
E07000127,West Lancashire,75-79,85,58,27
E07000127,West Lancashire,80-84,87,60,27
E07000127,West Lancashire,85-89,55,44,11
E07000127,West Lancashire,90+,51,28,23
E07000142,West Lindsey,0-4,411,319,92
E07000142,West Lindsey,05-Sep,337,277,60
E07000142,West Lindsey,41913,274,224,50
E07000142,West Lindsey,15-19,282,621,-339
E07000142,West Lindsey,20-24,850,738,112
E07000142,West Lindsey,25-29,639,637,2
E07000142,West Lindsey,30-34,534,447,87
E07000142,West Lindsey,35-39,420,285,135
E07000142,West Lindsey,40-44,329,284,45
E07000142,West Lindsey,45-49,369,292,77
E07000142,West Lindsey,50-54,370,298,72
E07000142,West Lindsey,55-59,307,227,80
E07000142,West Lindsey,60-64,305,185,120
E07000142,West Lindsey,65-69,232,204,28
E07000142,West Lindsey,70-74,206,164,42
E07000142,West Lindsey,75-79,98,96,2
E07000142,West Lindsey,80-84,69,89,-20
E07000142,West Lindsey,85-89,60,64,-4
E07000142,West Lindsey,90+,62,53,9
E07000181,West Oxfordshire,0-4,370,226,144
E07000181,West Oxfordshire,05-Sep,261,210,51
E07000181,West Oxfordshire,41913,228,220,8
E07000181,West Oxfordshire,15-19,230,645,-415
E07000181,West Oxfordshire,20-24,985,810,175
E07000181,West Oxfordshire,25-29,791,690,101
E07000181,West Oxfordshire,30-34,608,493,115
E07000181,West Oxfordshire,35-39,436,397,39
E07000181,West Oxfordshire,40-44,326,301,25
E07000181,West Oxfordshire,45-49,301,269,32
E07000181,West Oxfordshire,50-54,272,264,8
E07000181,West Oxfordshire,55-59,272,219,53
E07000181,West Oxfordshire,60-64,180,194,-14
E07000181,West Oxfordshire,65-69,173,152,21
E07000181,West Oxfordshire,70-74,152,114,38
E07000181,West Oxfordshire,75-79,80,74,6
E07000181,West Oxfordshire,80-84,97,65,32
E07000181,West Oxfordshire,85-89,103,45,58
E07000181,West Oxfordshire,90+,63,47,16
E07000191,West Somerset,0-4,110,84,26
E07000191,West Somerset,05-Sep,104,74,30
E07000191,West Somerset,41913,72,66,6
E07000191,West Somerset,15-19,115,166,-51
E07000191,West Somerset,20-24,248,332,-84
E07000191,West Somerset,25-29,159,200,-41
E07000191,West Somerset,30-34,129,141,-12
E07000191,West Somerset,35-39,115,98,17
E07000191,West Somerset,40-44,115,79,36
E07000191,West Somerset,45-49,137,90,47
E07000191,West Somerset,50-54,165,93,72
E07000191,West Somerset,55-59,211,138,73
E07000191,West Somerset,60-64,182,102,80
E07000191,West Somerset,65-69,187,103,84
E07000191,West Somerset,70-74,109,101,8
E07000191,West Somerset,75-79,51,57,-6
E07000191,West Somerset,80-84,26,34,-8
E07000191,West Somerset,85-89,23,55,-32
E07000191,West Somerset,90+,27,17,10
E09000033,Westminster,0-4,568,1112,-544
E09000033,Westminster,05-Sep,331,645,-314
E09000033,Westminster,41913,271,564,-293
E09000033,Westminster,15-19,1445,955,490
E09000033,Westminster,20-24,4445,3851,594
E09000033,Westminster,25-29,3787,3649,138
E09000033,Westminster,30-34,2643,3567,-924
E09000033,Westminster,35-39,1579,2629,-1050
E09000033,Westminster,40-44,1002,1479,-477
E09000033,Westminster,45-49,742,1089,-347
E09000033,Westminster,50-54,626,768,-142
E09000033,Westminster,55-59,434,597,-163
E09000033,Westminster,60-64,301,380,-79
E09000033,Westminster,65-69,171,275,-104
E09000033,Westminster,70-74,99,202,-103
E09000033,Westminster,75-79,63,124,-61
E09000033,Westminster,80-84,58,120,-62
E09000033,Westminster,85-89,42,89,-47
E09000033,Westminster,90+,25,58,-33
E07000053,Weymouth and Portland,0-4,157,181,-24
E07000053,Weymouth and Portland,05-Sep,156,157,-1
E07000053,Weymouth and Portland,41913,122,137,-15
E07000053,Weymouth and Portland,15-19,167,292,-125
E07000053,Weymouth and Portland,20-24,468,473,-5
E07000053,Weymouth and Portland,25-29,351,371,-20
E07000053,Weymouth and Portland,30-34,314,270,44
E07000053,Weymouth and Portland,35-39,219,211,8
E07000053,Weymouth and Portland,40-44,200,159,41
E07000053,Weymouth and Portland,45-49,229,205,24
E07000053,Weymouth and Portland,50-54,254,197,57
E07000053,Weymouth and Portland,55-59,229,139,90
E07000053,Weymouth and Portland,60-64,231,126,105
E07000053,Weymouth and Portland,65-69,204,138,66
E07000053,Weymouth and Portland,70-74,110,105,5
E07000053,Weymouth and Portland,75-79,71,71,0
E07000053,Weymouth and Portland,80-84,46,50,-4
E07000053,Weymouth and Portland,85-89,37,32,5
E07000053,Weymouth and Portland,90+,31,31,0
E08000010,Wigan,0-4,732,617,115
E08000010,Wigan,05-Sep,553,445,108
E08000010,Wigan,41913,359,402,-43
E08000010,Wigan,15-19,373,1049,-676
E08000010,Wigan,20-24,1793,1236,557
E08000010,Wigan,25-29,1517,1285,232
E08000010,Wigan,30-34,1265,953,312
E08000010,Wigan,35-39,826,740,86
E08000010,Wigan,40-44,542,477,65
E08000010,Wigan,45-49,539,469,70
E08000010,Wigan,50-54,480,415,65
E08000010,Wigan,55-59,334,346,-12
E08000010,Wigan,60-64,240,263,-23
E08000010,Wigan,65-69,187,193,-6
E08000010,Wigan,70-74,143,145,-2
E08000010,Wigan,75-79,86,84,2
E08000010,Wigan,80-84,71,79,-8
E08000010,Wigan,85-89,46,60,-14
E08000010,Wigan,90+,43,50,-7
E06000054,Wiltshire,0-4,1757,1234,523
E06000054,Wiltshire,05-Sep,1196,971,225
E06000054,Wiltshire,41913,1065,951,114
E06000054,Wiltshire,15-19,863,2864,-2001
E06000054,Wiltshire,20-24,3820,3441,379
E06000054,Wiltshire,25-29,2734,2445,289
E06000054,Wiltshire,30-34,2256,1759,497
E06000054,Wiltshire,35-39,1678,1201,477
E06000054,Wiltshire,40-44,1300,924,376
E06000054,Wiltshire,45-49,1210,1020,190
E06000054,Wiltshire,50-54,1079,1007,72
E06000054,Wiltshire,55-59,1052,920,132
E06000054,Wiltshire,60-64,829,704,125
E06000054,Wiltshire,65-69,633,570,63
E06000054,Wiltshire,70-74,556,411,145
E06000054,Wiltshire,75-79,290,290,0
E06000054,Wiltshire,80-84,252,235,17
E06000054,Wiltshire,85-89,247,180,67
E06000054,Wiltshire,90+,191,141,50
E07000094,Winchester,0-4,585,428,157
E07000094,Winchester,05-Sep,391,293,98
E07000094,Winchester,41913,434,293,141
E07000094,Winchester,15-19,1689,1042,647
E07000094,Winchester,20-24,2114,3125,-1011
E07000094,Winchester,25-29,1090,1203,-113
E07000094,Winchester,30-34,889,797,92
E07000094,Winchester,35-39,723,586,137
E07000094,Winchester,40-44,509,394,115
E07000094,Winchester,45-49,390,383,7
E07000094,Winchester,50-54,435,350,85
E07000094,Winchester,55-59,374,355,19
E07000094,Winchester,60-64,255,275,-20
E07000094,Winchester,65-69,210,194,16
E07000094,Winchester,70-74,183,146,37
E07000094,Winchester,75-79,109,89,20
E07000094,Winchester,80-84,102,79,23
E07000094,Winchester,85-89,87,82,5
E07000094,Winchester,90+,106,77,29
E06000040,Windsor and Maidenhead,0-4,617,560,57
E06000040,Windsor and Maidenhead,05-Sep,386,412,-26
E06000040,Windsor and Maidenhead,41913,679,366,313
E06000040,Windsor and Maidenhead,15-19,270,1175,-905
E06000040,Windsor and Maidenhead,20-24,1598,1188,410
E06000040,Windsor and Maidenhead,25-29,1237,1269,-32
E06000040,Windsor and Maidenhead,30-34,1176,1104,72
E06000040,Windsor and Maidenhead,35-39,965,843,122
E06000040,Windsor and Maidenhead,40-44,651,592,59
E06000040,Windsor and Maidenhead,45-49,554,513,41
E06000040,Windsor and Maidenhead,50-54,392,416,-24
E06000040,Windsor and Maidenhead,55-59,304,374,-70
E06000040,Windsor and Maidenhead,60-64,201,271,-70
E06000040,Windsor and Maidenhead,65-69,133,226,-93
E06000040,Windsor and Maidenhead,70-74,141,158,-17
E06000040,Windsor and Maidenhead,75-79,81,93,-12
E06000040,Windsor and Maidenhead,80-84,131,85,46
E06000040,Windsor and Maidenhead,85-89,99,65,34
E06000040,Windsor and Maidenhead,90+,60,64,-4
E08000015,Wirral,0-4,508,385,123
E08000015,Wirral,05-Sep,305,302,3
E08000015,Wirral,41913,256,208,48
E08000015,Wirral,15-19,286,1161,-875
E08000015,Wirral,20-24,1996,1557,439
E08000015,Wirral,25-29,1217,1054,163
E08000015,Wirral,30-34,897,776,121
E08000015,Wirral,35-39,686,491,195
E08000015,Wirral,40-44,480,405,75
E08000015,Wirral,45-49,446,386,60
E08000015,Wirral,50-54,414,351,63
E08000015,Wirral,55-59,310,283,27
E08000015,Wirral,60-64,303,222,81
E08000015,Wirral,65-69,217,179,38
E08000015,Wirral,70-74,194,119,75
E08000015,Wirral,75-79,111,92,19
E08000015,Wirral,80-84,75,59,16
E08000015,Wirral,85-89,69,73,-4
E08000015,Wirral,90+,55,71,-16
E07000217,Woking,0-4,409,469,-60
E07000217,Woking,05-Sep,239,347,-108
E07000217,Woking,41913,164,233,-69
E07000217,Woking,15-19,183,605,-422
E07000217,Woking,20-24,1132,789,343
E07000217,Woking,25-29,989,967,22
E07000217,Woking,30-34,878,854,24
E07000217,Woking,35-39,699,644,55
E07000217,Woking,40-44,411,480,-69
E07000217,Woking,45-49,278,372,-94
E07000217,Woking,50-54,209,344,-135
E07000217,Woking,55-59,164,252,-88
E07000217,Woking,60-64,121,212,-91
E07000217,Woking,65-69,68,111,-43
E07000217,Woking,70-74,75,113,-38
E07000217,Woking,75-79,51,70,-19
E07000217,Woking,80-84,55,55,0
E07000217,Woking,85-89,66,51,15
E07000217,Woking,90+,62,70,-8
E06000041,Wokingham,0-4,878,489,389
E06000041,Wokingham,05-Sep,654,326,328
E06000041,Wokingham,41913,432,323,109
E06000041,Wokingham,15-19,874,1183,-309
E06000041,Wokingham,20-24,2277,2453,-176
E06000041,Wokingham,25-29,1515,1339,176
E06000041,Wokingham,30-34,1578,953,625
E06000041,Wokingham,35-39,1257,706,551
E06000041,Wokingham,40-44,785,514,271
E06000041,Wokingham,45-49,546,497,49
E06000041,Wokingham,50-54,378,407,-29
E06000041,Wokingham,55-59,304,380,-76
E06000041,Wokingham,60-64,195,326,-131
E06000041,Wokingham,65-69,151,212,-61
E06000041,Wokingham,70-74,117,164,-47
E06000041,Wokingham,75-79,89,94,-5
E06000041,Wokingham,80-84,95,77,18
E06000041,Wokingham,85-89,102,73,29
E06000041,Wokingham,90+,77,45,32
E08000031,Wolverhampton,0-4,1031,937,94
E08000031,Wolverhampton,05-Sep,658,652,6
E08000031,Wolverhampton,41913,499,417,82
E08000031,Wolverhampton,15-19,753,1120,-367
E08000031,Wolverhampton,20-24,2296,2181,115
E08000031,Wolverhampton,25-29,1493,1686,-193
E08000031,Wolverhampton,30-34,1294,1348,-54
E08000031,Wolverhampton,35-39,939,923,16
E08000031,Wolverhampton,40-44,700,648,52
E08000031,Wolverhampton,45-49,544,585,-41
E08000031,Wolverhampton,50-54,444,456,-12
E08000031,Wolverhampton,55-59,327,336,-9
E08000031,Wolverhampton,60-64,213,234,-21
E08000031,Wolverhampton,65-69,140,185,-45
E08000031,Wolverhampton,70-74,91,109,-18
E08000031,Wolverhampton,75-79,75,74,1
E08000031,Wolverhampton,80-84,74,80,-6
E08000031,Wolverhampton,85-89,95,61,34
E08000031,Wolverhampton,90+,86,48,38
E07000237,Worcester,0-4,211,377,-166
E07000237,Worcester,05-Sep,166,238,-72
E07000237,Worcester,41913,149,191,-42
E07000237,Worcester,15-19,949,508,441
E07000237,Worcester,20-24,1607,1967,-360
E07000237,Worcester,25-29,831,996,-165
E07000237,Worcester,30-34,588,662,-74
E07000237,Worcester,35-39,342,498,-156
E07000237,Worcester,40-44,260,355,-95
E07000237,Worcester,45-49,262,301,-39
E07000237,Worcester,50-54,269,263,6
E07000237,Worcester,55-59,182,231,-49
E07000237,Worcester,60-64,124,153,-29
E07000237,Worcester,65-69,123,118,5
E07000237,Worcester,70-74,98,91,7
E07000237,Worcester,75-79,57,54,3
E07000237,Worcester,80-84,74,55,19
E07000237,Worcester,85-89,64,38,26
E07000237,Worcester,90+,38,47,-9
E07000229,Worthing,0-4,376,352,24
E07000229,Worthing,05-Sep,252,220,32
E07000229,Worthing,41913,195,200,-5
E07000229,Worthing,15-19,240,463,-223
E07000229,Worthing,20-24,853,725,128
E07000229,Worthing,25-29,797,722,75
E07000229,Worthing,30-34,679,569,110
E07000229,Worthing,35-39,526,405,121
E07000229,Worthing,40-44,427,321,106
E07000229,Worthing,45-49,353,342,11
E07000229,Worthing,50-54,336,322,14
E07000229,Worthing,55-59,257,254,3
E07000229,Worthing,60-64,215,177,38
E07000229,Worthing,65-69,191,162,29
E07000229,Worthing,70-74,209,136,73
E07000229,Worthing,75-79,124,102,22
E07000229,Worthing,80-84,122,81,41
E07000229,Worthing,85-89,110,76,34
E07000229,Worthing,90+,94,79,15
E07000238,Wychavon,0-4,467,270,197
E07000238,Wychavon,05-Sep,357,217,140
E07000238,Wychavon,41913,279,167,112
E07000238,Wychavon,15-19,249,626,-377
E07000238,Wychavon,20-24,996,805,191
E07000238,Wychavon,25-29,859,712,147
E07000238,Wychavon,30-34,660,445,215
E07000238,Wychavon,35-39,566,355,211
E07000238,Wychavon,40-44,419,245,174
E07000238,Wychavon,45-49,455,266,189
E07000238,Wychavon,50-54,469,360,109
E07000238,Wychavon,55-59,406,282,124
E07000238,Wychavon,60-64,335,236,99
E07000238,Wychavon,65-69,314,170,144
E07000238,Wychavon,70-74,279,194,85
E07000238,Wychavon,75-79,144,112,32
E07000238,Wychavon,80-84,104,113,-9
E07000238,Wychavon,85-89,87,102,-15
E07000238,Wychavon,90+,83,81,2
E07000007,Wycombe,0-4,644,614,30
E07000007,Wycombe,05-Sep,521,431,90
E07000007,Wycombe,41913,448,372,76
E07000007,Wycombe,15-19,463,1183,-720
E07000007,Wycombe,20-24,1909,1899,10
E07000007,Wycombe,25-29,1195,1360,-165
E07000007,Wycombe,30-34,1176,1046,130
E07000007,Wycombe,35-39,892,802,90
E07000007,Wycombe,40-44,571,606,-35
E07000007,Wycombe,45-49,436,478,-42
E07000007,Wycombe,50-54,347,410,-63
E07000007,Wycombe,55-59,289,434,-145
E07000007,Wycombe,60-64,213,317,-104
E07000007,Wycombe,65-69,139,224,-85
E07000007,Wycombe,70-74,146,168,-22
E07000007,Wycombe,75-79,96,106,-10
E07000007,Wycombe,80-84,84,76,8
E07000007,Wycombe,85-89,91,77,14
E07000007,Wycombe,90+,70,74,-4
E07000128,Wyre,0-4,322,274,48
E07000128,Wyre,05-Sep,259,213,46
E07000128,Wyre,41913,279,197,82
E07000128,Wyre,15-19,366,600,-234
E07000128,Wyre,20-24,861,732,129
E07000128,Wyre,25-29,563,567,-4
E07000128,Wyre,30-34,438,430,8
E07000128,Wyre,35-39,401,282,119
E07000128,Wyre,40-44,289,221,68
E07000128,Wyre,45-49,328,195,133
E07000128,Wyre,50-54,373,237,136
E07000128,Wyre,55-59,377,240,137
E07000128,Wyre,60-64,353,174,179
E07000128,Wyre,65-69,368,178,190
E07000128,Wyre,70-74,278,143,135
E07000128,Wyre,75-79,156,120,36
E07000128,Wyre,80-84,116,101,15
E07000128,Wyre,85-89,70,80,-10
E07000128,Wyre,90+,62,64,-2
E07000239,Wyre Forest,0-4,243,213,30
E07000239,Wyre Forest,05-Sep,206,154,52
E07000239,Wyre Forest,41913,160,131,29
E07000239,Wyre Forest,15-19,166,376,-210
E07000239,Wyre Forest,20-24,615,500,115
E07000239,Wyre Forest,25-29,490,419,71
E07000239,Wyre Forest,30-34,368,307,61
E07000239,Wyre Forest,35-39,257,251,6
E07000239,Wyre Forest,40-44,233,186,47
E07000239,Wyre Forest,45-49,276,229,47
E07000239,Wyre Forest,50-54,288,198,90
E07000239,Wyre Forest,55-59,250,172,78
E07000239,Wyre Forest,60-64,193,132,61
E07000239,Wyre Forest,65-69,162,149,13
E07000239,Wyre Forest,70-74,119,128,-9
E07000239,Wyre Forest,75-79,80,78,2
E07000239,Wyre Forest,80-84,64,54,10
E07000239,Wyre Forest,85-89,45,38,7
E07000239,Wyre Forest,90+,48,37,11
E06000014,York,0-4,376,495,-119
E06000014,York,05-Sep,282,313,-31
E06000014,York,41913,184,246,-62
E06000014,York,15-19,4751,984,3767
E06000014,York,20-24,4441,6743,-2302
E06000014,York,25-29,1767,2285,-518
E06000014,York,30-34,1103,1228,-125
E06000014,York,35-39,639,847,-208
E06000014,York,40-44,477,496,-19
E06000014,York,45-49,424,531,-107
E06000014,York,50-54,397,439,-42
E06000014,York,55-59,331,345,-14
E06000014,York,60-64,282,294,-12
E06000014,York,65-69,214,240,-26
E06000014,York,70-74,170,163,7
E06000014,York,75-79,95,94,1
E06000014,York,80-84,94,74,20
E06000014,York,85-89,54,73,-19
E06000014,York,90+,55,47,8
